across-the-board = без всяких исключений; во всех аспектах; повсеместно
albeit = даже хотя; хоть и; пусть даже и; хотя и; пусть и; несмотря на
all the while = тем временем; все это время; долгое время; в то же время; пока; в это самое время
although = несмотря на то что; хотя; если бы даже
an old saying = старая поговорка
and so forth = и так далее; и т.д.; и т. д.; и другие; и прочие; и т. п.
apart from that = кроме того
as a whole = в целом; в совокупности; целиком; как единое целое
as far as = поскольку; по мере; до самого; насколько можно; насчёт; по мере того, как; сколь
as it stands = на данный момент; в текущей формулировке; как оно есть; на данном этапе
as it turns = как оказалось
as it turns out = как выясняется
as such = как таковой
as though = словно; будто; как будто; как если бы
as well as = так же как
attack surface = поверхность атаки; вид атакиx
back and forth = взад и вперёд; туда и сюда; в ту и в другую сторону; туда-сюда; досконально; со всех сторон; возвратно-поступательно
back to back = один за другим; друг к другу; встык; взаимная нагрузка; обратная работа
bare-bones = примитивный; незатейливый; самое необходимое
bear in mind = следует учитывать; учесть; принимать во внимание; запоминать; иметь в виду; помнить
bears the blame = нести ответственность; принимать на себя ответственность
before long = скоро; вскоре; в ближайшее время; не сегодня-завтра; со дня на день
belabor the point = зацикливаться; жевать одно и то же по кругу; пережёвывать одно и то же; муссировать
besides that = мало того, что; помимо этого; кроме того
better yet = а лучше; а ещё лучше
beyond me = выше моего понимания; непонятно; непостижимо
boil down = вывариват; выпаривать; сгущать; сокращать; сжимать
bona fide = честный; добросовестный; настоящий; добросовестно; верный; подлинный; стоящий; достойный
bootstrap = начальная загрузка; самонастройка
break down = раскрывать; расстраиваться; поломать; разбить; срыв; детализация; не выдерживать; разрушить; анализировать; разбирать; разделить; расчленять; провалиться; портиться; распадаться; рухнуть
bugs me = нервирует
bull-headed = большеголовый; широколобый; своевольный; упрямый; бесшабашный; безрассудный
catfight = перебранка; перепалка; грызня; склока между женщинами
chime in = вступать в общий разговор
clutter up = засаривать; захламлять; загромождать; загромоздить
cobble up = ставить заплаты; делать на скорую руку; делать кое-как; сварганить
condition hold = условие
core grained = крупнозернистый
crop up = появляться; возникать; возникнуть; обнажаться
dab hand = тыкать рукой
daily basis = ежедневный; каждодневный; повседневный
data-centric = документоориентированный подход; информационно-центрический
demanding a refund = требовать возврат
died on the vine = умер на лозе; неосуществимость; неудача на ранней стадии
do the deed = сделать дело; оправляться; справлять нужду
doesn't mind = не против
dole out = раздавать; выдавать; распределять
drum-banger = активный сторонник
e.g. = например; напр.; к примеру
either way = так или иначе; так и этак; как бы то ни было; и в том и в другом случае; каким-нибудь образом
end up = окончиться; прекратиться; оборваться; закончить; найти себя
end-to-end = непрерывный; двухпозиционный; впритык; встык; комплектный; торец к торцу
even so = всё же; и всё же; всё-таки; даже в таком случае; даже при этих условиях; и так; точно так; именно так
even though = хотя; мало ли что; хотя бы; и хотя; если бы даже; даже если; даром что; хоть и
every bit = совершенно; все; полностью; точно; вылитый; во всех отношениях
falls short = отстает; не хватать; не достигать; не достигать цели; не предполагать
fell swoop = одним махом
fencepost error = ошибка на единицу; ошибка поста охранения
fine grained = мелкомодульный; мелкослойный; микрогранулированный; дотошный; очень точный; очень подробный; мелкозернистый; тонкозернистый
first things first = сначала о главном; обо всём по порядку; для начала
flat-out = прямо; открыто; напрямик; отчаянный; предельный
flesh out = конкретизация
for lack = из-за отсутствия
foremost = в первую очередь
former instead of the latter = первый вместо последнего; бывший вместо последнего
from scratch = с азов; заново; на пустом месте; с чистого листа
from within = изнутри; из
full-blown = полноценный; полнофункциональный
fully qualified = полный; полностью подготовленный
furthermore = кроме того; к тому же; более того; при этом
garden-variety = обычный; заурядный
gee = вот так так; вот это да; вот здорово; фу ты
generically = в общем
get around = обвести; навещать; обмануть; передвигаться; переубедить; перехитрить; посещать
get bogged down = увязнуть
given the way = учитывая то, как
go overboard = впадать в раж; лезть из кожи вон; не знать меры; переходить границы; переборщить; перегнуть палку; прыгнуть за борт; перестараться; переусердствовать; быть в восторге
go-to = палочка-выручалочка; один из лучших; доверенное лицо; правая рука
goes beyond this = выходит за рамки этого
going to = собираться; переходя к
groundwork = фундамент; фон; наработки; основа
grunt work = тяжёлая работа; утомительная работа; рутинная работа
hand it = передать его
hand off = передача управления; передавать
hang on = крепко держаться; полагаться; рассчитывать; прицепляться
has a little something up its sleeve = имеет кое что в своем рукаве
have you ever had = у тебя когда-нибудь было
head over = направляться; перейти
heavy use = активное использование; интенсивный режим
heavy-handed = деспотический; нескладный; грубый; неуклюжий; неловкий; тяжеловесный
hit the bricks = попасть за решётку; сесть в тюрьму; проваливать; сваливать; бастовать
hodgepodge = мешанина; всякая всячина; сборная солянка
however = однако; как бы ни; тем не менее; несмотря на это
i.e. = то есть; т.е.; т.к.
in a nutshell = в двух словах; короче говоря; словом; коротко и ясно; если выделить главное
in advance = раньше времени; перед; не позднее чем за; в преддверии; заранее
in and of itself = сам по себе; как таковой
in doing so = при этом
in due time = в свое время
in effect = в результате; в действительности; в сущности; по существу; на практике
in either case = в любом случае
in either event = в любом случае; так или иначе; и в том и другом случае; во всяком случае
in their own right = полноправный; сами по себе; в их собственных правах
indirect approach = косвенный подход
it bears repeating = стоит еще раз повторить
it’s worth noting = стоит отметить
jumping through hoops = прыгать через обручи; надрывался; плясать под дудку; выбиваться из сил
just as = точно так же, как; когда; в то время как
just as there = так же, как есть
keep your eyes peeled = гляди в оба; смотри внимательно
kick off = сбросить; сбрасывать; дохнуть; начать игру
kick the tires = похлопать по шинам; посмотреть; обкатать
kick up a notch = бери выше
know the drill = понимать что к чему; знать, что надо делать
laser focused = узкоспециализированный
left off = брошенный; остановиться; бросать; отставать; отвыкать
lend a hand = помогать; подсобить; выручать
lifeblood = источник жизненной силы; кровеносная система
likewise = также; подобно; более того; тоже; аналогично
line item = статья расходов; позиция
live up to = не умереть до; быть достойным; соблюдать; жить по
long-held = давний; давнишний; устоявшийся
loosely speaking = грубо говоря; проще говоря; примерно говоря
match up = соотносить; сочетать; подходить; соответствовать
meanwhile = между тем; тем временем; пока; что касается, то; в это время
meet the criteria = подпадать под признаки; соответствовать признакам; удовлетворять условиям
mental shift = сдвиг в сознании
mixing up = размешивать; спутать; перепутать; впутывать; путать; разнообразить
monkey see, monkey do = копировать; обезьянничать
more than meets the eye = больше, чем кажется на первый взгляд
muck about = возиться; убивать время; дурачиться; слоняться
multiprecision arithmetic = арифметические операции с многократно увеличенной точностью
mutually exclusive = взаимоисключающий; несовместимый
nail down = прибивать; закреплять; подкреплять; поймать на слове
namely = именно; то есть; а именно; т. е.
native peer = собственный аналог
nevertheless = тем не менее; всё же; как бы то ни было; хотя; несмотря на; однако
nitty-gritty = повседневная работа
no brainer = очевидно; элементарно; ежу понятно; проще некуда; простак
no pun intended = простите за каламбур; без каламбура
no stone will be left unturned = не оставить камня на камне
nonetheless = тем не менее; всё же; при этом; а ведь; несмотря на это; все-таки
not to mention = не говоря уже о; не говоря уж; не говоря уже; не говоря о; не считая
now that = теперь, когда
nowadays = настоящее; в наше время; в наши дни; ныне; теперь; настоящее время; нынче
occasionally = время от времени; иногда; порой
odd prime = нечётное простое число
odd-looking = странного вида
ol = перегрузка
omitted for brevity = для краткости опущены
on your behalf = от вашего имени
one of a handful = один из немногих
opposed to being = в отличие от
opt in = регистрироваться; зарегистрироваться; согласиться; явно согласиться
opt-in = согласиться; явно согласиться
opts out = не принимать участия; устраняться; уклоняться; выйти из игры; сознательно уйти
other than that = кроме этого
other way around = наоборот; с обратной стороны; с противоположной стороны
otherwise = в противном случае; противоположный; иной; другой; иначе; по-другому
out of the blue = нежданно-негаданно; ни с того ни с сего; на пустом месте; вдруг
out-of-the-box = по умолчанию; установочный
outweigh all the cons = перевесить все минусы
performance-wise = с точки зрения производительности
pin down = связывать; связать; сковывать; определиться с; остановиться на
pipe dream = несбыточная мечта; пустая мечта; голубая мечта
play a part = играть роль; притвориться; притворяться; сыграть роль
point out = обращать внимание; указывать; напоминать; обозначить
points to = указывает на
poke about = допытываться
pop out = вываливаться; выскочить; внезапно гаснуть; внезапно отправиться
pop up = всплыть; внезапно возникать; внезапно выскакивать
pretty much = очень; в большой степени; в значительной степени; почти; пожалуй; практически; почти что; можно сказать; фактически
primarily = в первую очередь
prime numbers = простые числа
pros and cons = за и против; плюсы и минусы; положительные и отрицательные стороны; аргументы за и против; преимущества и недостатки
provides us with = предоставляет нам; дает нам
pull off = снять; выдернуть; несмотря на трудности; успешно завершить; организовать
put off = отдалять; откладывать; отложить; отодвигать; перенести; переносить; снимать; отделаться
put simply = а если проще; словом; короче говоря
put succinctly = помещенный лаконично
put together = составлять; скомбинировать; вместе взятые
putting up = давать приют; возводить; поселяться; останавливаться; остановиться; повышать; вкладывать
qa environment = среда тестирования
quite literally = в буквальном смысле слова
rather than = вместо того, чтобы; нежели; в отличие от
reasonably-sized = разумных размеров
regardless = не смотря на; не считаясь; независимо; независимо от
right away = сразу; немедленно; тотчас
round trip = поездка туда и обратно; поездка в оба конца; турне; круиз; туда и обратно
same song, second verse = та же песня, второй стих
scale back = умерить; сократить; сбавить; поутихнуть
sense of security = уверенность в завтрашнем дне; чувство надежности; чувство защищённости; чувство безопасности
set apart = отложить; приберегать; приберечь; отделять; разнимать; откладывать в сторону
set aside = аннулировать; не принимать в расчёт; откладывать в сторону; приберегать; откладывать
similarly = по аналогии
simple matter = простой вопрос
slippery slope = скользкая дорожка; опасный спуск; опасное дело; опасная стезя
so called = так называемый; именуемый; с позволения сказать; якобы
so far = до сих пор
so forth = и так далее; и тому подобное
stack up = наложение; расположить один за другим; складывать в стопку
stands for = стоять за; означать; представлять; соответствовать; значить; быть кандидатом
staying out = отсутствовать; не возвращаться домой; выдерживать до конца; пересиживать; быть в гостях
stick with = не изменяться; не бросать; держаться; предпочитать
stub application = заглушка
surprisingly = поразительно; на удивление; как ни странно; неожиданно
swap out = заменить; поменять на; сменить
tailor made = мужского покроя; строгая женская одежда; строгих линий
take over = идти на смену; переправлять; принимать от другого; сменять; отвоевать
taking place = проходить; вершиться; вестись; разыграться
that is to say = другими словами; иначе говоря; иными словами; то есть; именно; таким образом; а именно
that said = при этом; исходя из этого; вместе с тем; с другой стороны; и все таки
that, in turn = что, в свою очередь
thereby = таким образом; в связи с этим; посредством этого; из-за этого; тем самым; вследствие этого; с помощью этого
therefore = следовательно; по этой причине
these include = к их числу относятся; они включают
thinly disguised = плохо скрываемый; почти открытый
thought of = приходить на ум; додумываться; быть какого-л. мнения; воображать; думать; заботиться; замышлять
throughout = на протяжении
thus = таким образом; как следствие; потому
thus far = до сих пор
tinkering around = возиться
to be frank = откровенно говоря
to by = от
to truly = по настоящему
tried and true = верный; испытанный; надежный; проверенный
trigger off = пробудить; породить; приводить в движение
turn hand to = заняться делом; приступить к работе
ultimately results = в конечном счете, приводит к
unit circle = единичная окружность; круг с радиусом, равным единице
until last = напоследок; до конца; до последних пор
up to = соответствие; до включительно; вплотную; на усмотрение
up to a point = постольку-поскольку; в чем-то; до какого-то момента; до определённой степени; в определённой степени; в некоторой степени; с оговорками
up to this point = до этого момента
vice versa = наоборот; обратно
viz = именно; а именно; как то; то есть
web surfer = интернет-пользователь; веб-пользователь
well-rounded = с хорошим кругозором; всесторонне развитый; целостный
well-versed = искушённый; разбирающийся; поднаторевший; опытный
what goes around comes around = все возвращается на круги своя; как аукнется так и откликнется; за что боролись, на то и напоролись
whatever = без разницы; какой бы ни; любой; какой бы то ни было
whatsoever = что бы ни было; что угодно; всё, что; вообще; совсем; какой бы ни
when it comes = когда речь идет о
when it comes to = когда дело доходит до
whereas = тогда как; поскольку; в связи с тем, что
whether = будь то; любой из двух; стоит ли; может ли; ли
with that said = с учетом сказанного
wrapping up = закутывать; запаковывать; обдавать; давать краткое заключение; завершать; кутаться; доводить до ума; закругляться
yet to be = ещё не

backlash
classified
conman
coziness
galvinise
graduate
humility
impetus
incentivized
inquiry
plea
popped up
prejudise
raise eyebrows
subceptible
counterfeit
interchangeably
abandon = отказываться; оставлять; сдавать; покидать; прекращать
abbreviate = сокращать; урезывать
abhor = питать отвращение; ненавидеть; гнушаться; испытывать отвращение; презирать; не выносить; побрезгать
able = способный; талантливый; квалифицированный; умелый; подлежащий
abnormally = ненормально; аномально; неправильно; критически; чрезмерно
abortion = прерывание; недоразвитие; аварийное прекращение
abridge = сокращать; ограничивать; урезывать; лишать
absence = отсутствие; отлучка; недостаток; рассеянность
absent = несуществующий; отсутствующий
absorb = всасывать; впитывать; поглощать; абсорбировать; понимать; постигать; улавливать
abuse = брань; ругательства; оскорбление; злоупотребление; ругань; поругание
abysmally = несоизмеримый; несопоставимый; несоразмерный; непропорциональный
accept = принимать; допускать; соглашаться
accommodate = вмещать; улаживать; приспосабливать
accomplish = выполнять; завершать; доводить до конца; совершать; совершить
according = соответствовать; предоставлять; жаловать; гармонировать
accordingly = соответственно; таким образом; следовательно; поэтому; в соответствии
account = счёт; расчёт; подсчёт; отчётность; сводка; учётная запись
accurate = точный; правильный; тщательный; прилежный; меткий
accurately = точно; правильно; безошибочно; тщательно; аккуратно
accuse = обвинять; винить; придираться; порицать; предъявлять обвинение
accustom = приучать; приучить; приучаться; осваиваться; освоиться; привыкать; привыкнуть; вживаться
achieve = достигать; добиваться; успешно выполнять
acquaint = познакомить; сообщать; извещать; познакомиться
acquire = приобретать; получать; достигать; овладевать; заказ; захватывать
acronym = аббревиатура; акроним; сокращение
actuator = привод; преобразователь; рычаг воздействия
ad = реклама
adamant = непреклонный; несокрушимый; твёрдый; несгибаемый; твёрдо убеждённый; упрямый; категоричный; непоколебимый; настойчивый
adapt = приспособлять; приспосабливаться; адаптироваться; применяться к; адаптировать
addict = наркоман; раб привычки; пьяница; человек, страдающий пристрастием
adequately = достаточно; соответственно; адекватно; компетентно; удовлетворительно
adhere = приклеиваться; придерживаться; оставаться верным; остаться верным; соблюсти
adjective = зависимый; подчинённый; несамостоятельный
admittedly = по общему признанию; общепризнанно; признаться; по общему согласию; как признано; предположительно; заведомо; впрочем
ado = суета; суматоха; беспокойство; хлопоты
adopt = принимать; усваивать; выбирать; перенимать; усыновлять; удочерять; признавать в качестве
adopted = выбранный; заимствованный; принятый
adoption = усыновление; принятие; заимствование; усвоение; усваивание
advance = продвигаться; идти вперёд; наступать; продвигать; делать успехи; развиваться
advantage = преимущество; польза; выгода
advent = возникновение; появление; наступление события; выход в свет
advertise = помещать объявление; рекламировать; подчёркивать; извещать; создавать рекламу
advisable = рекомендуемый; целесообразный; благоразумный; желательный; разумный
advisably = разумно; выгодно; уместно; благоразумно; целесообразно
aesthetically = эстетически
affect = действовать; влиять; волновать; трогать; задевать
afford = позволить себе; доставлять; иметь возможность; быть в состоянии
afterthought = запоздалая мысль; запоздалое соображение; второстепенный вопрос; посредственность
afterward = впоследствии; потом, позже; позже; потом
aggregate = совокупность; соединение; агрегат; заполнитель; весь; комплекс
agile = подвижный; проворный; быстрый; живой; сообразительный; беглый; поворотливый
agility = подвижность; проворство; быстрота; живость; ловкость; сообразительность; беглость; прыть
agnostic = агностический; недогматический; независимый; нейтральный
ahead = будущий; предстоящий; вперёд
aid = помощь; содействие; поддержка; помощник; средство; вспомогательное средство; пособие
akin = родственный; родной; близкий; сродный; сродни
align = выравнивать; совмещать
allegation = утверждение; голословное утверждение; заявление
allegedly = по утверждению; вроде бы; по неофициальной информации; как гласит легенда
alleviate = облегчать; смягчать; сглаживать; заглушать
allocate = предназначать; назначать; ассигновывать; распределять; отводить; размещать
allocated = предназначать; назначать; ассигновывать; распределять; отводить; размещать
allot = отводить; предназначать; назначать; отчислять; распределять
allott = отводить; предназначать; назначать; отчислять; распределять
along = вдоль; по; в соответствии; параллельно; рядом; на основании; совместно
alongside = рядом; около; бок о бок; вблизи
alphabetization = расположение в алфавитном порядке; создание алфавита
alphabetize = упорядочить по алфавиту; расположить в алфавитном порядке
alternatively = или же; вперемежку; поочерёдно; иначе; наоборот; как вариант
altogether = совокупность; вместе; вполне; совсем; в целом; в общем
amass = собирать; накапливать; копить; набирать; складывать; собрать
ambiguity = неоднозначность; двойственность; неточность
amenable = послушный; сговорчивый; покладистый; подверженный; склонный; расположенный; ответственный; подсудный; податливый
amend = исправлять; улучшать; изменять к лучшему; внести поправки
amiss = ошибочный; неверный; неправильный; несоответствующий; некстати; дурно; плохо
among = между; в числе; среди
amount = составлять; доходить до; достигать; равняться
ancestor = предок; прародитель; родоначальник
anchor = якорь; крюк
ancillary = вспомогательный; помощник; ассистент; дополнение
annual = ежегодный; годовой; годичный; однолетний
anticipate = ожидать; предвидеть; предчувствовать; предвкушать
antithetical = прямо противоположный; несовместимый; обратный
apace = быстро; вровень; в ногу; спешно; стремительно; активно; уравнять; скоро; проворно; шустро
apart = в отдалении; в стороне; обособленно; в сторону; порознь; врозь; на части; на куски; кроме; не считая; не говоря о
apparent = видимый; различимый; явный; очевидный; несомненный
appeal = апеллировать; призывать; просить; молить; умолять; привлекать
appear = появиться; показываться; выходить; издаваться
appearance = появление; внешность; наружность; видимость
appliance = приспособление; устройство; прибор; электроприбор; применение
applicable = применимый; пригодный; соответствующий; подходящий
application = применимость; представление; старание; устройство; прибор; аппаратура; расходование
applied = использован; приложен; прикладной; практический
apply = применять; обратиться; употреблять; прилагать; накладывать; прикладывать; относиться; распространиться; ходайствовать
appoint = назначать; утверждать; условливаться
appreciate = ценить; высоко ставить; оценивать
appreciation = высокая оценка; признательность; благодарность; понимание; правильное восприятие
approach = сближение; подход; заход; подъезд
appropriate = подходящий; соответствующий; уместный; надлежащий; свойственный; присущий
approximate = приближённый; примерный; сходный
approximately = приблизительно; предположительно; порядка; на глаз
approximation = приближение; приближённое значение; приблизительная величина; аппроксимация; адекватность; тождественность; приблизительное соответствие
aptly = умело; надлежащим образом; как нельзя лучше; как и полагается
arbitrary = произвольный; капризный; самовольный; невыдержанный; необоснованный; субъективный
arbor = ось; оправка; беседка; дерево; вал
arduous = трудный; напряжённый; энергичный; крутой; ревностный
arguably = спорно; возможно; вероятно; пожалуй; сомнительный
arise = возникать; появляться; проистекать; являться результатом; подниматься; воскресать
arrange = приводить в порядок; классифицировать; уславливаться; договариваться; приходить к соглашению; уладить
arrogant = высокомерный; надменный; заносчивый; самонадеянный; наглый; бесцеремонный; с гонором
article = предмет; вещь; статья; пункт; параграф; соглашение; заметка
artificial = искусственный; не природный; притворный; надуманный
artificially = неестественно; выделанно; вычурно
aside = в стороне; отступление; второстепенное событие
assemble = созвать; собраться; компонировать; соорудить; набрать
assert = утверждать; заявлять; доказывать
assess = облагать налогом; штрафовать; оценивать; определять сумму; расценивать
assign = поручать; назначать; определять; предназначать
assignment = назначение; ассигнование; распределение; выделение; передача; предназначение; присваивание
assume = допускать; принимать; присваивать; предполагать; предположить; предпологать
assuming = допуская; принятие; исходя из того; при условии; при условии, что; принимая во внимание
assumption = допущение; присвоение; притворство; высокомерие; самонадеянность
atop = наверху; сверху; на; поверх; над; на вершине; во главе
atrocious = жестокий; свирепый; зверский; скверный; ужасающий; мерзкий
attempt = пытаться; пробовать; покушаться; попытка; проба; опыт
attend = посещать; присутствоват; уделять внимание; быть внимательным; заботиться; следить
attorney = адвокат; юрист; прокурор
attractive = притягательный; заманчивый; благовидный; благообразный; интересный; располагающий; привлекательный
augment = увеличение; прибавление; приращение; увеличивать; прибавлять; доработать; повысить
authentic = подлинный; аутентичный; достоверный; верный; заверенный
authentication = идентификация; удостоверение подлинности; аутентификация
authority = полномочие; авторитет; влияние; доступ
auxiliary = вспомогательный; сопроводительный; подчинённый; добавочный; дополнительный; запасной; служебный; временный; обслуживающий
available = доступный; свободный; действительный; имеющийся; пригодный
avalanche﻿ = лавина; снежный обвал; град
average = средний; обычный; нормальный; среднестатистический; составлять; достигать
averse = нерасположенный; несклонный; питающий отвращение; отвергающий; неохотный
aversion = отвращение; антипатия; неохота; гадливость; предотвращение; неприятие; неприязнь
avert = отводить; отвлекать; предотвращать; предотвратить
await = ждать; ожидать; дожидаться; предстоять; предстоять; пока не
aware = сознающий; знающий; осведомлённый; предупреждённый
awe = благоговейный страх; трепет; благоговение
awful = ужасный; отвратительный; страшный; неслыханный; кошмарный; зверский
awkward = неуклюжий; неловкий; нескладный; затруднительный
awry = кривой; искажённый; неправильный
backbone = основа; суть; сущность; позвоночник
backing = поддержка; одобрение; подкрепление; субсидирование; финансирование; подкладка
bait = приманка; наживка; искушение
bandwidth = производительность; пропускная способность; ширина зоны; диапазон частот
bare = нагой; голый; обнажённый; пустой; едва достаточный; поношенный; бедный
bargain = торговая сделка; договор о покупке; договорённость; торговаться; рядиться
bark = образовывать; ободрать; ошкуривать; гавкать; обдирать; сдирать кожу; рявкать
batch = серия; партия; кучка; пачка; ряд
bearing = переносить; перевозить; нести; держаться; иметь; выдерживать; опираться
bedrock = основание, краеугольный камень; фундамент
behalf = в защиту; в пользу; в сочетаниях; ради
belabor = избивать; подвергать нападкам; бить; колотить; трепать; вдалбливать; излишне повторяться; объяснять очевидное
beneficial = благотворный; полезный; целительный; выгодный; целебный; благодетельный; доброжелательный
benefit = преимущество; привилегия; польза; благо; выгода
berate = ругать; бранить; поносить
bewilder = озадачивать; приводить в недоумение; ставить в тупик; сбивать с толку; смущать
beyond = вне; за пределами; вдали; сверх
bidirectional = двунаправленный; реверсивный; разнонаправленный; двухсторонний
biennial = двулетний; двухлетний; двухгодичный
bigram = диграмма; биграмма; группа из двух разрядов
bind = связывание; связанность; связь; узы; путы; плеть; зануда
bizarre = эксцентричный; дикий; экстравагантный
blanket = шерстяное одеяло; попона; покров; тяжёлое облако; густой туман
bleak = блёклый; холодный; суровый; унылый; мрачный; открытый; бесцветный; бледный; пустынный; голый
blemish = недостаток; пятно; позор; прыщик; дефект; повреждение; изъян; искажать; исказить
bliss = блаженство; счастье; нега; безмятежность; наслаждение
bloat = раздуваться; пухнуть; коптить; опухать
blob = капля; шарик; нуль; пузырь; сделать кляксу
blunder = грубая ошибка; промах; просчёт; оплошность; халатность
bog = трясина; болото; увязать; тонуть в трясине
bogus = фальшивый; надуманный
boldface = выделительный шрифт; жирный шрифт; полужирный шрифт
bookend = служить концом; происходить в конце; основа; обрамлять; венчать; совершить в промежутке между
bootstrap = улучшать; запускать; самоподдержка; инициализация приложения
borrow = заимствовать; занимать; брать на время; одалживать
boundary = граница; барьер; экран; рубеж
branch = ветка; ответвление; отрасль
brazen = медный; бронзовый; похожий на медь; бесстыдный; наглый
breed = порода; потомство; поколение; род; категория; размножаться; плодиться
brevity = краткость; недолговечность; лаконизм; сжатость; немногословие
brittle = хрупкий; ломкий; раздражённый; нервный; нестабильный; козинак
broad = широкий; обширный; просторный; свободный; терпимый; явный; полный
broadcast = вещать; выступать по медиа; широко распространять; передать по радио; распространять
broadly = широко; свободно; в общих чертах
broker = агент; посредник; торговец
brought = приносить; привозить; доставлять
browsing = просмотр; просматривание; изучать
built-in = встраиваемый; прирожденный; заложенный; присущий; собственный
bulk = величина; масса; объём; ссыпать; сваливать в кучу; нагромождать
bulletproof = пуленепробиваемый; гарантированный; ошибкоустойчивый
bump = столкновение; ударяться; бить
bunch = кучка; группа; связка; пучок; пачка
burden = ноша; тяжесть; груз; бремя
burdensome = обременительный; тягостный; раздражающий; докучливый; тяжёлый
bureau = бюро; отдел; управление; комитет
burglar = ночной грабитель; взломщик; вор; грабитель; вор-взломщик; домушник
burst = взрываться; разрываться; взрывать; лопаться; прорываться
buzzword = сленг; модное слово; жаргон; расхожее слово
bypass = обходить; идти обходным путём; вилять; хитрить
cadence = модуляция; понижение; спад; гармония; тактовый сигнал
calculus = расчёты; исчисление; дифференциальное и интегральное исчисление; математический анализ; теория аппроксимации; численные методы
callee = вызываемый
canonicalize = канонизировать
capability = способность; возможность; возможности
capable = способный; могущий; действенный, эффективный; в силах
capacity = предел; ёмкость; вместимость; объём; пропускная способность; способность
careless = небрежный; неаккуратный; беспечный; беззаботный; легкомысленный
carry = перевозка; поддержка; грузоподъёмность; достигнуть; достигать; долетать
cartesian = декартовы координаты
cast = преобразовать; бросать; кидать; швырять; метать; разбрасывать; сбрасывать
castaway = потерпевший кораблекрушение; изгнанник; нечестивец; никому не нужный; отверженец
cause = причина; быть причиной; мотив; повод; служить поводом; вызвать
caution = осторожность; осмотрительность; предусмотрительность; предостережение; предупреждение; предупреждать; делать предупреждение
cautioned = предупреждать; предостеречь; предосторожность
cautioning = предостерегательный; предупреждение
caveat = предостережение; предупреждение; протест; оговорка
cease = прекращать; останавливать; приостанавливать
cede = сдать; уступить; передать; оставлять; признавать правоту; поступаться
celebrity = известность; слава; знаменитость; знаменитый человек; величина
centerpiece = центральный элемент; базовая деталь; основной вопрос; важнейшая составляющая; краеугольный камень
centralize = централизовать; концентрировать; концентрироваться; сосредоточиваться
certain = определенный; неизменный; постоянный
certainty = уверенность; определённость; стабильность
challenge = вызывать; бросать вызов; сомневаться; отрицать; оспаривать; подвергать сомнению; требовать
challenging = спорный; высокой сложности
charge = загрузка; заряд; забота; попечение; надзор; хранение
chart = морская карта; карта; схема; таблица; план
checkout = подсчёт; отладка; выселение
cheer = аплодировать; ободрить; поощрять; ликовать
chore = рутина; скучное дело
chunk = ломоть; комок; лязгать; грохотать
churn = размешивать; взбалтывать; взбивать; вспенивать
circularity = округлость; обтекаемость; замкнутость; цикличность; кругообразность
circumference = длинна окружности
circumstances = обстоятельства; условия; положение дел
circumvent = обмануть; перехитрить; обойти
cite = ссылаться; цитировать; вспоминать; вызывать
claim = требовать; претендовать; предъявлять претензию; заявлять права; утверждать; заявлять; требование; претензия; иск; рекламация
clash = сталкиваться; стукаться; совпадать; врезаться
clause = утверждение; статья; пункт; условие; оговорка
cling = цепляться; держаться; облегать; прилипать
clue = клубок; ключевой; ход мыслей; путеводная нить; ключ к разгадке; раскрыть секрет; навести на мысль
clumsy = неуклюжий; неповоротливый; грубый; топорный; неизящный
clunky = корявый; неповоротливый; громоздкий
clutter = беспорядок; хаос; шум; гам; хлам; барахло
coarse = грубый; крупный; крупнозернистый; шероховатый; сырой; невежливый; непристойный; вульгарный
cobble = булыжник; грубая починка; мостить; топорно чинить
coda = заключительная часть; эпилог
coerce = удерживать; сдерживать; принуждать; заставлять
coexist = сосуществовать; жить в мире
cogent = убедительный; неоспоримый; обоснованный; бесспорный
coherent = связанный; сцепленный; связный; понятный
cohesive = сплоченный; способный к сцеплению; связующий
coincident = одновременный; синхронный; сопутствующее обстоятельство
coined = придуманный; чеканить; выбивать
collar = воротник; воротничок; ожерелье; ошейник; хомут; кольцо; обруч
collateral = побочный; второстепенный; параллельный; косвенный; попутный
collision = столкновение; противоречие; коллизия
comma = запятая
commence = стартовать; вступить в силу; начать; зачинать
commit = совершать; поручать; вверять; фиксировать изменения
commitment = обязательство; вручение; передача
comparison = сравнение; сопоставление
compel = заставлять; принуждать; добиться; подчинить; заставить; принудить
compelling = непреодолимый; неотразимый; веский; захватывающий; убедительный
competitor = участник; соперник; конкурент; соревнующийся
compilation = составление; компиляция; компилирование; компиляция
complain = жаловаться; выражать недовольство; подавать жалобу; плакаться; обжаловать; подать претензию; подать иск
complaint = недовольство; причина недовольства; болезнь; недуг
complement = дополнение; комплект; личный состав
completable = дополняемый; завершаемый
complexity = сложность; запутанность; запутанное дело; комплексность
compliant = податливый; уступчивый; угодливый; сговорчивый; покладистый; послушный
compline = повечерие; вечернее богослужение; ночное богослужение
comply = исполнять; подчиняться; уступать; соглашаться
compose = составить; сочинять; создавать; задумать
compound = сложное слово; огороженная территория; смесь; состав; соединение
comprehensive = комплексный; всеобъемлющий; исчерпывающий; полный; обширный; понятливый
comprise = включать; заключать в себе; составлять; охватывать
compromising = ставя под угрозу; компрометирование; примиренческий
compunction = угрызения совести; раскаяние; сожаление
concede = уступать; допускать; признавать; согласиться; проигрывать
conceivable = постижимый; понятный; мыслимый; возможный; вероятный; потенциальный
conceivably = по всей видимости; вероятно; предположительно
conceive = постигать; понимать; возыметь
conceived = предложенный; сконструированный; воспринятый
concept = понятие; идея; общее представление; методология
conceptually = идейно; мысленно; по идее; по своему характеру; по существу; чисто теоретически
concern = отношение; беспокойство; забота; касаться; описывать; беспокоить; интересоваться; заниматься
concerned = имеющий отношение; связанный; заинтересованный; озабоченный; обеспокоенный; занятый
concert = концерт; согласие; соглашение; уговор
concise = краткий; сжатый; сокращённый; конспективный; немногословный; чёткий
concisely = сжато; кратко; выразительно; ёмко
conciseness = сжатость; краткость; выразительность
conclude = заканчивать; завершать; заключать; сделать вывод; решать; принимать решение
concoct = состряпать; выдумать; стряпать; заварить; придумать
concurrency = совпадение; параллельность; взаимосовместимость
condition = состояние; положение; обстоятельства; условие
conditional = условный; обусловленный; зависящий от
conduct = вести; сопровождать; водить; руководить; проводить; дирижировать
conductive = способствующий; проводящий; располагающий
confess = признавать; сознаваться; исповедовать; исповедаться; каяться
confidence = доверие; конфиденциальное сообщение; секрет; уверенность
confident = уверенный; самоуверенный; самонадеянный; смелый; без сомнений
confidently = уверенно; убеждённо; доверительно
confine = ограничивать; заточить; держать взаперти
confirmation = подтверждение; доказательство; утверждение; подкрепление
confluence = слияние; соединение; стечение народа; толпа; стечение; место слияния
confronted = сталкиваться; столкнуться; противостоять; сопоставленный
conjunction = соединение; связь; совпадение; стечение; сочетание; перекрёсток; железнодорожная ветка; пересечение дорог
connectivity = связь; взаимосвязь; возможность взаимодействия; подключаемость; способность к подключению
conscious = сознающий; понимающий; сознание; бодрствующий
consecutive = последующий; последовательный; следственный; непрерывный
consent = согласие; разрешение; соглашение; дозволение; позволение; согласование
consequence = следствие; последствие; результат; вывод; заключение; значение
consequently = вследствие этого; поэтому; в результате
consider = рассматривать; обсуждать; обдумывать; принимать во внимание; учитывать
considerably = значительно; гораздо; намного
consistency = последовательность; логичность; постоянство; плотность; стабильность; системность
consistent = сообразный; согласующийся; последовательный
consistently = последовательно; согласованно; в соответствии с
constituent = элемент; избиратель; составляющая; доверитель; субъект
constitute = составлять; учреждать; основывать; образовывать; издавать; составить; основать
constrain = сдерживать; ограничивать
constraint = принуждение; ограничение; давление; связанность
consume = потреблять; расходовать; поглощать; чахнуть; израсходовать
contemplate = созерцать; пристально рассматривать; размышлять; обдумывать
contemporary = современник; современный; одновременный; модерновый; актуальный
contend = бороться; сражаться; состязаться; соперничать; спорить; утверждать
contender = соперник; претендент; кандидат
contention = раздор; разногласие; спор; препирательство; точка зрения; утверждение; соревнование; борьба; ссора
contextual = связанный с контекстом; ситуативный; содержательный
contradict = противоречить; возражать; опровергать; отрицать; возразить
contrary = противоречащий; обратный
contribute = делать вклад; способствовать; содействовать; сотрудничать; участвовать
contrive = изобретать; придумывать; затевать; ухитряться; умудряться
contrived = изобретать; придумывать; затевать; ухитряться; умудряться
controversial = спорный; дискуссионный; полемический
convenience = удобство; комфорт; преимущество; выгода
convenient = удобный; подходящий; под рукой
convention = собрание; съезд; договор; соглашение; обычай; общее согласие; условность
conventional = общепринятый; традиционный; обусловленный; условный; стандартный; вежливый
conversation = переговоры; разговор; диалог
conversational = разговорный; диалоговый; интерактивный
converse = общение; обратное; противоположное; разговор; положение; дискурс; общаться; беседовать; преобразовывать; объясниться
conversely = обратно; противоположно; наоборот; верно и обратное
conveying = доставка; передача; развозка; перевозить; транспортировать; передавать
convicted = признать виновным; осудить
convince = убеждать; уверять; убедить
convoluted = скручивать; сворачивать; завёрнутый; свитой
coop = курятник; тюрьма
cope = крыть; покрывать; справиться; управляться; покров; кабина; колпак; справляться; оборачивать; осваивать
corollary = следствие; заключение; результат; итог
correspond = отвечать; представлять собою; быть аналогичным; состоять в переписке; согласовываться
corresponding = соответственный; соответствующий; подобный; аналогичный
costly = дорогой; ценный; роскошный; пышный; разорительный
couch = излагать; формулировать; выражать; притаиться; проращивать
could = мог
counterintuitive = парадоксальный; нелогичный; неожиданный; противоречащий здравому смыслу
counterpart = двойник; копия; дубликат; аналог; эквивалент; неотъемлемая часть; сверстник; нечто, дополняющее другое
couple = соединять; сцеплять; связывать; пара; парные предметы; чета
coupling = соединение; сцепление; стыковка
court = дворцовый; придворный; судебный
covariance = ковариантность; смешанный второй момент; соизменимость
covariant = соизменимый; ковариантный
cram = наполнять; переполнять; набивать битком; нахватанные знания; зубрёжка
crammed = наполнять; переполнять; набивать битком; впихивать
credentials = полномочия; мандат; удостоверение
credible = заслуживающий доверие; правдоподобный; подобный; авторитетный
cripple = калечить; уродовать; делать непригодным; наносить вред; хромать
criterion = критерий; мерило; определяющий фактор; логическое условие; норматив; примета; мера
crooks = ворье; вор на воре; всякий сброд
crop = подстригать; подрезать; обрезать; сеять
cross-cutting = сквозной; прошивка
crucial = решающий; ключевой; критический; крестообразный
crud = вздор; чепуха; ерунда; чушь собачья; подонок; мразь
crude = сырой; предварительный; примерный
cryptic = скрытый; тайный; таинственный; загадочный; сокровенный; криптовый
cucumber = огурец
cue = сигнал; намёк; ключ
culminate = завершаться; достигать вершины
culminating = завершающий
culprit = виновный; причина проблемы; нарушитель
cumbersome = громоздкий; нескладный; обременительный; неуклюжий; неповоротливый
curate = высматривать; опекать; выбирать; отбирать; викарий; второй священник прихода
cure = лекарство; средство; лечение; курс лечения; излечение; чудак
curious = любознательный; пытливый; любопытный; странный
cursory = поверхностный; беглый; поспешный; небрежный
custom = самодельный; пользовательский; специальный; свой; собственный
customary = обычный; привычный; принятый; сложившийся
cypher = высчитывать; вычислять; зашифровывать; оперировать цифрами; подсчитывать; гудеть
dangle = качать; качнуть; свеситься; качаться; висеть
darn = штопать; чинить; проклинать; ругаться; замкнуть
data persistence = сохранение данных
deal = дело, соглашение; сделка; распределять; раздавать; отпускать; выдавать; снабжать
decent = подобающий; достаточный; приличный; пристойный
decidedly = решительно; окончательно; бесспорно; явно; несомненно
decive = обманывать
decompose = разложить; разлагаться; растворять
decouple = разъединять; расцеплять; развязывать
dedicate = посвящать; предназначать; посвящённый; преданный; убеждённый
dedication = посвящение; преданность; самоотверженность; стремление; одержимость
deduce = устанавливать происхождение; сличать
deem = полагать; думать; считать; квалифицировать
deemed = условный; подразумеваемый; считается
default = параметры по умолчанию; значения по умолчанию; нарушать
deficiencies = недоимки; недоработки
deficiency = отсутствие; нехватка; дефицит; недостаток; неполноценность
deficient = лишённый; несовершённый; недостаточный; неполный; дефектный; недостающий; не имеющий; слабоумный; ограниченный
definitely = определённо; ясно; точно; несомненно; наверное; наверно; обязательно; достоверно; конкретно; непременно; окончательно
definitive = окончательный; бесповоротный; отличительный; решительный; безусловный
defunct = несуществующий; исчезнувший; вымерший; покойный; скончавшийся; умерший; усопший
degree = ступень; степень; колено; положение; ранг; звание; градус; уровень
deliberately = преднамеренно; умышленно; нарочно; неспешно; неторопливо; решительно
deliberation = обдумывание; взвешивание; размышление; дискуссия; осторожность; осмотрительность; неторопливость
delightful = восхитительный; очаровательный; прелестный; сладостный; дивный; упоительный
delineate = обозначить; очерчивать; обрисовывать; вычерчивать
delusion = обман; заблуждение; иллюзия; призрачная, несбыточная мечта; обольщение; мания
delve = погружаться; углубляться в изучение; доискиваться; выкапывать; извлекать; копать; делать изыскания; изучать; тщательно исследовать; рыться; копаться
demand = требование; настойчивая просьба; потребность; запрос; команда; спрос
demise = сдавать в аренду; завещать имущество; передавать по наследству; предоставлять; кончина
demote = разжаловать; снижать; низводить; смещать с должности; понижать в звании
denote = указывать; показывать; отмечать; обозначать
departure = отъезд; уход; отбытие; отправление; уклонение
depict = изображать; описывать; запечатлевать; нарисовать; обрисовывать
depiction = описание; изображение; портрет; рисунок: картина
deploy = развёртывать; разблокировать; задействовать
deprecate = выступать против; энергично возражать; протестовать; резко осуждать
dereference = разыменовать; снимать косвенность
derivation = источник; происхождение; извлечение
derivatives = производные; язык-потомок; производное число; продукт замещения
derive = получать; извлекать; происходить; наследовать; выводить; черпать
descend = спускаться; сходить; снижаться; опускаться; происходить
descendant = потомок; отпрыск; наследник
descriptive = изобразительный; наглядный; начертательный; образный; содержательный
designate = определять; устанавливать; указывать; обозначать
despicable = презренный
despise = презирать; ни во что не ставить; гнобить; не выносить; оплёвывать
despite = несмотря; вопреки; невзирая; назло
destination = место назначения; назначение; предназначение; пункт прибытия
destine = назначать; предназначать; предопределять; направлять; предназначить; предопределить
determine = определять; устанавливать; обусловливать; побуждать; заставлять; решать
deterministic = однозначный; детерминированный; определённый; обусловленный
detract = принижать; умалять; приуменьшать; отнимать; вычитать; злословить
deviation = отклонение; отступление; девиация; уклонение
devious = непрямой; окольный; хитрый; неискренний
devise = придумывать; изобретать; разрабатывать; задумать; выдумывать
devoid = лишённый; не имеющий
devote = посвящать; отдавать целиком; отводить; уделять; посвятить; уделить
dictum = изречение; афоризм; авторитетное заявление
digress = отступать; отклоняться; отходить; отвлекаться
diligence = прилежание; усердие; старание; старательность; дилижанс; приказ о явке
diligent = прилежный; усердный; старательный; неустанный; кропотливый
dire = внушающий ужас; предвещающий несчастье; безотлагательный; катастрофический
disadvantage = недостаток; вред; ущерб; убыток; невыгода; невыгодное положение; неудобство; помеха; отставание
disastrous = бедственный; гибельный; катастрофический; зловещий
discard = отбрасывать; отвергать; отказываться; списывать; браковать
disclaimer = отрицание; отклонение; отвод; опровержение
disclose = раскрывать; открывать; обнажать; показывать
discourage = приводить в уныние; обескураживать; расхолаживать; отбивать охоту; отговаривать
discrete = прерывистый; дискретный; раздельный; отдельный
discretion = осторожность; осмотрительность; рассудительность; благоразумие
discriminator = распознаватель; дешифратор; сравнивающее устройство; различитель
disguise = маскировка; лицемерие; обман; переодевание; сокрытие; утаивание
dismiss = опускать; увольнять; отпускать; отчислить
disparity = несоответствие; неравенство; несоразмерность; диспропорция; дифференциация
dispatch = отправка; отсылка; донесение; депеша
dispense = распределять; раздавать; обходиться; отправить
dispenser = распылитель; раздаватель; торговый автомат; раздаточное устройство
displace = перемещать; переставлять; перекладывать; вытеснять; смещать
disposal = передача; вручение; избавление; размещение; расстановка; возможность распорядиться; устранение
dispose = располагать; размещать; расставлять; склонять; отдавать; передавать
disregard = игнор; пренебрежение; равнодушие; неуважение
dissect = разрезать; рассекать; анализировать; вскрывать; анатомировать
distil = дистиллировать; очищать; очистить; опреснять
distill = выкуривать; выкурить; гнать самогон; дестиллировать
distinct = ясный; отчётливый; членораздельный; определённый
distinction = распознавание; разграничение; разница; отличие; различие; знатность; известность; оригинальность; индивидуальность
distinguish = различать; разглядеть; распознавать; узнавать; обособлять; характеризовать; отличать; различить; рассмотреть
distract = отвлекать; уводить в сторону; рассеивать
distraction = отвлечение; рассеянность; развлечение; безумие; раздражение
distribute = распределять; раздавать; разносить; распределять
distribution = раздача; распространение; размещение; дистрибуция; делёж; выдача; рассылка; расстановка
disuse = неправильное использование; нерабочее состояние; неупотребление; неупотребительность
ditch = ров; канава; кювет
diverge = расходиться; отклоняться; отходить; приобретать отличие; разниться
divert = отвести; отклонить; отвлечь; позабавить; развлечь; рассеивать
dole = пособие по безработице; вспомоществование; горе; подачка; пособие; доля; небольшое пособие; подаяние
domain = территория; владение; имение; область; сфера; предмет
doubly = вдвое; нечестно; двойственно; дважды
doubtful = сомнительный; подозрительный; колеблющийся; недостоверный
douche bag﻿ = спринцовка; придурок
downside = оборотная сторона; непривлекательная сторона; нижний уровень
dozen = дюжина
draft = набросок; эскиз; чертёж; проект
drastically = решительно; круто; радикально
drawback = недостаток; изъян; препятствие; помеха
dread = бояться; страшиться; содрогаться от страха; опасаться; дрожать; с ужасом ждать
dreaded = страшный; ужасный; устрашающий
drill = бур; бурав; тренировка; упражнение
drop-in = вклинивание сигнала; появление ложного сигнала
due = надлежит; следует; должный; надлежащий
dumping = разрыв; разгрузка
durable = долговременный; надёжный; крепкий; длительного пользования; долговечный; прочный; длительный; жизнестойкий
duration = продолжительность; отрезок времени; срок; время; продолжение службы; длительность; срок действия; течение срока
dwell = жить; пребывать; остановиться; подробно останавливаться
dwindling = сокращаться; уменьшаться; убывать; истощаться; ухудшаться; вырождаться; приходить в упадок; терять значение
eager = страстно стремящийся; жаждущий; нетерпеливый; энергичный
eagerly = охотно; с рвением; усердно; алчно; с жадностью; нетерпеливо; в охотку; охотно; горячо; рьяно
edgewise = остриём; краем; боком; остриём вперёд; краем; в возражение
effective = эффективный; действующий
effectively = фактически; по существу
efficient = квалифицированный; эффективный; действенный; рациональный; умелый
efficiently = рационально; разумно; производительно; грамотно
effort = усилие; попытка; стремление
effortlessly = играючи; без труда; непринуждённо; без лишних усилий; с лёгкостью; на раз-два
either = либо; любой; каждый; оба; и тот и другой
elaborate = разрабатывать
eligible = могущий; имеющий право; подходящий; желательный
elude = избегать; уклоняться; ускользать
embark = погрузиться; предпринимать; согласились
embarrass = беспокоить; смущать; приводить в замешательство; сбивать с толку
embed = вставлять; врезать; вмазывать; вделывать; вкраплять
embody = воплощать; претворять в жизнь; реализовать; олицетворять; включать; заключать в себе; содержать
embrace = объятие; объятия; обвивать; осваивать
emerge = появляться; показываться; выходить; выйти
emerging = появление
emit = испускать; излучать; выделять; издавать; распространять; извергать
emphasis = подчёркивание; эмфаза; акцент; выразительность
emphasize = подчёркивать; придавать особое значение; выделять; делать ударение; придавать выразительность; акцентировать; оттенять
emphasizing = подчёркивать; придавать особое значение; выделять; делать ударение; акцентировать; оттенять
employ = употреблять; использовать; применять; предоставлять работу; нанимать
empower = добеспечивать возможность; придавать уверенность
enable = на основе; поддерживать; позволять; приспосабливать; давать возможность
enclose = заключать; окружать; огораживать; окаймлять; вкладывать; загораживать
encompass = окружать; обносить; обводить; заключать; заключить; содержать; сосредоточить в себе
encounter = встретить; наталкиваться; сталкиваться
encourage = поощрять; ободрять; воодушевлять
encumber = затруднять; препятствовать; мешать; стеснять; загромождать; обременять
endeavor = стремление; попытка; стараться; попытаться
endorse = расписываться; подтверждать; одобрять; подтвердить; поддерживать
endpoint = крайняя точка; конечный пункт; терминал; удаленный участник
enforce = взыскивать; настаивать на; приводить в жизнь; усиливать; настаивать; исполнять; осуществлять; исполнение; принудительно осуществлять
enforcement = давление; принуждение; принудительное исполнение
enforcing = предписание; осуществление; обеспечение; определение
enigmatic = загадочный; таинственный; малопонятный; неведанный
enormous = громадный; огромный; грандиозный; чудовищный; бешеный; ужасающий; невероятный; неимоверный
enqueue = поставленный в очередь; блокировка
ensemble = единое; стройное целое; согласованность; ансамбль
entail = влечь за собой; вызывать; навлекать; повлечь за собой
entailing = сопряжённый; вызывающий; стимулирование
entirely = полностью; всецело; вполне; совсем; совершенно; исключительно
entry = вступление; вхождение; занесение; вход
enumerate = перечислять; точно подсчитывать; переписывать; проводить перепись
envelope = конверт; обёртка; обложка; оболочка; покрышка
envision = представить себе; предвидеть; задумывать
equate = считать равным; равнять; уравнивать; уравнять; ставить знак равенства
errata = опечатка; описка
erratic = колеблющийся; рассеянный; странный; беспорядочный; ошибочный
erstwhile = прежде; некогда; бывало; бывший; давнишний
especially = в особенности; главным образом; в частности; особенно; в первую очередь
essence = сущность; эссенция; субстрат; существенность
essential = обязательный; существенный; важнейший; основа
essentially = по существу
establish = основывать; учреждать; организовывать; устанавливать
estate = имущество; положение; право собственности
estimate = оценивать; устанавливать стоимость; давать оценку; судить
estimation = оценка; суждение; мнение; уважение; расчёт; подсчёт; вычисление
evaluate = вычислять; оценивать
even = вровень; даже; точно; хоть; ровный; гладкий; равномерный
eventually = в конечном счёте; в итоге; в конце концов
evict = выселять; изгонять; выгнать на улицу
eviction = выселение; лишение собственности; экспроприация
evident = очевидный; явный; ясный; наглядный; налицо
evidently = очевидно; явно; ясно; несомненно; видимо; очевидным образом
evocation = возбуждение; вызывание к жизни; индукция; ответная реакция; воскрешение в памяти
evolve = развивать; развёртывать; эволюционировать; превращаться; выделять
exact = точный; аккуратный; строгий; требовать; добиваться; вымогать
exaggerated = преувеличивать; увеличивать; чрезмерно подчёркивать
exaggeration = преувеличение; превышение; перебор; перекос; излишество
exceed = превышать; переступать границы; доминировать
excel = отличаться; выделяться; превосходить
excerpt = отрывок; выдержка; выписка; цитата; отдельный оттиск; фрагмент
excess = излишний; избыточный; дополнительный; неиспользованный
excessive = чрезмерный; излишний; лишний; повышенный
exchange = обмен; передача; замена
excite = волновать; побуждать; будоражить; взвинчивать; дразнить
exciting = возбуждающий; волнующий; захватывающий; увлекательный
exclusively = исключительно; единственно; только; непосредственно; монопольно
exemplary = примерный; образцовый; достойный подражания; типичный; типовой; иллюстративный; поучительный; сделанный в назидание; показательный
exercise = упражнение; тренировка; обучать; тестировать
exhaustion = изнурение; истощение; изнеможение; вытягивание; высасывание; выпуск; разрежение
exhaustive = исчерпывающий; истощающий; всесторонний; обстоятельный
exhibit = показывать; обнаруживать; проявлять; выставлять; экспонировать
expense = трата; издержки; возмещение расходов; статья расхода; затрата; за счёт
explain = объяснять; толковать; разъяснять
explanation = объяснение; пояснение; разъяснение; оправдание; толкование
exploit = использовать; разработать; развить; разведывать; эксплуатировать; разрабатывать
exploration = исследование; разведка; изыскание
explore = исследовать; изучать; выяснять
exponentiation = возведение в степень
expose = воздействовать; разоблачать; подвергать; выделять; предоставлять
exposure = представление; выставление; подвергание; приобщение; погружение; экспозиция
extend = протягивать; вытягивать; простирать; натягивать; тянуться; расширять; удлинять
extensibility = возможность обобщения; возможность продолжения; возможность распространения; возможность расширения
extensible = растяжимый; продолжаемый; расширяемый
extensive = обширный; пространный; экстенсивный; широкий; протяжённый
externalize = воплощать; облекать
extra = добавочный; дополнительный; особый
extract = извлекать; вытаскивать; вытягивать; выжимать
extralinguistic = внеязыковой; экстралингвистический; неязыковой
extraneous = внешний; поступающий извне; чуждый; посторонний; не связанный; излишний; чужеродный
extraordinary = необычайный
extras = накладные расходы; побочные расходы; массовка
extreme = чрезмерный; предельный; высший; экстремальный	крайность; чрезмерность; экстремальное значение
fabric = ткань; материя; структура
facet = грань; фаска; аспект
facilitate = облегчать; помогать; способствовать
facilities = оборудование; удобства; устройства; материальные средства
facility = несложность; способность; гибкость; плавность; канал связи; раздел обеспечения
fair = честный; справедливый; беспристрастный; законный; посредственный; светлый
fairly = довольно; вполне; сносно; изрядно
fairness = справедливость; красота; объективность; достоверность
fallback = отступление; отход; запас; резерв; выпадение; падение; запасной вариант; альтернатива
fanout = разветвление
far-fetched = надуманный; притянутый за уши; нереальный
farfetched = искусственный; надуманный; неправдоподобный; натянутый; изощрённый; дутый; выдуманный; придуманный
fashion = образ; манера; вид; фасон; покрой; форма; мода
faucet = вентиль; втулка; раструб; затычка
feasible = возможный; вероятный; правдоподобный; оправданный; обоснованный; реалистичный
feat = трюк; умение; подходящий; годный; проворный; опрятный; изящный
feature = параметр; характеристика; особенность; примета
fed = кормили; накормленный; обеспеченный
feed = кормить; давать пищу; питать; снабжать; пасти; кормиться
fell = валить; сваливать; сбивать с ног; убить
felony = фелония; просчёт; преступное деяние; тяжкое преступление
fencepost = стойка ограждения
ferret = сыщик; разыскивать; рыться; шарить; преследовать; беспокоить; выкурить из норы
ferry = перевозить; переезжать; перегнать; доставлять; перебрасывать
fetch = получать; выбрать; извлекать
fewer = меньше; меньшее количество
fickle = непостоянный; переменчивый; ненадёжный
figuratively = метафорически; образно; фигурально; условно; в переносном смысле
finegrained = мелкомодульная; маломодульная
finer = ясный; хороший; превосходный; тонкий
firmly = накрепко; плотно; решительно; чётко; глубоко; устойчиво; непоколебимо; надёжно
fishy = невыразительный; с рыбным вкусом; с рыбным запахом; тусклый
fit = годный; подходящий
fixture = приспособление; прибор; подставка; прикрепление
flaky = чудной; хлопьевидный
flappable = неуравновешенный; нервный
flatten = делать плоским, ровным, гладким; разглаживать; сглаживать; выравнивать
flavor = разновидность; вкус; запах
flaw = изъян; брак; порок; недостаток; упущение; трещина; ошибка; щель; дефект; разрыв
flawlessly = чётко; грамотно; без запинок; идеально
fledge = оснащать; экипировать; способный летать; оперившийся
flex = сгибать; гнуть; согнуть; изгибать; напрягать
flip = слегка ударить; щёлкнуть; смахнуть
flock = стадо; стая; отара; толпа; стекаться; скапливаться
flop = провал; шлёпанье; хлопок; внезапная перемена
flour = мука; крупчатка; порошок; пудра
fluent = плавный; свободно говорящий; разговорчивый; текучий; жидкий; напыщенный
flunk = провал; провалиться; завалить
flux = течение; поток; постоянное движение; флюс; постоянная смена
fondness = нежность; любовь; пристрастие
footprint = след; отпечаток; отпечаток ноги; объём памяти
forecast = прогноз
forego = предшествовать; отказываться; воздерживаться; отказаться
forehead = лоб; передняя часть; передовой забой
foremost = передний; передовой; первый; основной; главный; выдающийся; вперёд; прежде всего; во-первых
forensic = судебный; аналитический
foresight = предвидение; предусмотрительность; предсказание
forgery = подлог; подделка; фальшивка; фальсификация
forgo = отказываться от; воздерживаться от; не воспользоваться; воздерживаться; отказываться; отказывать; поступаться
fork = разветвляться; работать вилами; разветвиться; раздвоиться
former = прежний; бывший; предшествующий; давний; былой
formerly = прежде; раньше; некогда; ранее; в прошлом; когда-то; ранее называвшийся
forth = выбить; выбивать; выйти вперёд; дальше; наружу; впредь; ниже; далее; из
fortify = усиливать; поддерживать; укреплять
foundation = основание; обоснованность; принципы
foundry = литейная; литейный цех; литьё; плавильня; литейный завод; плавильное производство
fraction = частица; доля; крупица; обломок; осколок; преломление
fractional = дольный; относительный; дробный
fragile = хрупкий; ломкий; слабый; недолговечный; преходящий
fraught = полный; преисполненный; чреватый
frequently = зачастую; часто; неоднократно; нередко; обычно; сплошь и рядом
friction = трение; растирание; конфликт; сцепление; шум; трения; разногласия; замедление работы
frown = хмурить брови; насупиться; относиться с неодобрением
frustrate = срывать; несостоявшийся; сорвавшийся; расстроить
fulfill = выполнять; исполнять; удовлетворять
full-fledged = вполне оперившийся; развившийся; созревший; завершивший подготовку; законченный; развёрнутый; полный
fungus = гриб; поганка; плесень; древесная губка; грибок; низший гриб; грибы
funnel = воронка; жерло; дымоход
furnish = снабжать; предоставлять; доставлять; давать; представлять; обставлять; меблировать
further = дальнейший; дополнительный; добавочный; дальше
fuse = плавиться; сплавлять; сваривать; соединять; сливать
fuss = суетиться; волноваться по пустякам; чрезмерно заботиться
gain = получать; приобретать; зарабатывать; добывать
gap = щель; пробел; пропуск; расхождение; пропасть
gaze = взгляд; пристальный взгляд; взор
generic = родовой; характерный; типичный; стандартный
generous = великодушный; благородный; щедрый; большой
gentle = приветливый; мягкий; добрый; кроткий; ласковый
genuine = подлинный; истинный; настоящий; искренний; неподдельный
gesture = жест; телодвижение; мимика; ужимка
gizmo = штуковина; штука
glance = быстрый взгляд; вспышка; блеск; сверкание; скользящий удар; упоминание
glean = собирать по крупицам; подбирать; собирать по мелочам; почерпнуть
glimpse = мелькание; мимолётное впечатление; быстрый взгляд
globbing = подстановка
gloss = наводить глянец; придавать блеск; лосниться; приукрашивать; замазывать; делать заметки; снабжать комментариями
goes to great lengths = идет очень долго; идет на большие дистанции
goodness = праведность; благо; совершенство; нравственность
gotcha = попался; подводные камни
gracefully = грациозно; изящно; элегантно; вежливо
gradually = постепенно; последовательно; мало-помалу; понемногу
grain = раздроблять; измельчать; придавать зернистость; кристаллизовать
granted = даровать; жаловать; дарить; разрешать
granularity = глубина детализации; степень детализации; дробность; зернистость
grasp = схватывать; захватывать; сжимать; зажимать; хвататься; ухватиться; хвататься
gratuitously = бесплатно; даром; безвозмездно; беспричинно; необоснованно; малообоснованно; безосновательно; произвольно
grinding = размалывать; перемалывать; толочь; растирать
grip = схватить; сжать; крепко держать; понимать; схватывать; овладевать вниманием; затирать; зажимать
grocery = бакалейная лавка; бакалейная торговля; бакалея
grumble = жаловаться; грохотать; греметь; брюзжать; заворчать; поворчать; роптать
grumpy = сердитый; сварливый; раздражительный; брюзгливый
grunt = хрюкать; крякать; ворчать; кряхтеть; пробурчать
guess = догадываться; предполагать; угадывать; отгадывать
guided = вести; направлять
guideline = принцип; нормы; директива; руководящее указание; краткий заголовок; основополагающие положения; методическая инструкция
guise = личина; облик
gut = узкий проход; существенная часть; кишка
habit = привычка; обычай; обыкновение; особенность; свойство
halt = останавливать; обрывать; прекращать; останавливаться; колебаться; запинаться
handful = горсть; пригоршня; небольшое количество
handle = брать; оперировать; перемещать
handy = удобный; доступный
hang = подвешивать; висеть; навешивать
happenstance = случайность; случайное происшествие; стечение обстоятельств
harass = беспокоить; тревожить; утомлять; изводит
harassing = издевательство; преследование
hardline = бескомпромиссный; закоренелый; радикальный
harm = вред; ущерб; зло; неприятность; обида
hassle = перебранка; трудность; препятствие; закавыка; барьер
haste = поспешность; торопливость; спешка; опрометчивость
haul = тянуть; тащить; волочить; буксировать; перевозить
havoc = опустошение; разорение; разрушение; разруха
haystack = стог сена; скирда; скирд
hazard = азарт; риск; шанс
headaches = неприятность; помеха; головная боль; мучение; проблемы; причина беспокойства
heap = нагромождать; складывать; сваливать в кучу; накапливать; скапливать
hefty = большой; тяжёлый; обильный; мощный; массивный; внушительный; значительный
heighten = повышать; усиливать; повышаться; усиливаться; преувеличивать; раздувать
heinous = отвратительный; мерзкий; гнусный; ужасный; чудовищный
hence = следовательно; в результате; отсюда; с этих пор; прочь
heritage = наследие; происхождение
hesitate = колебаться; сомневаться; не решаться; стесняться; запинаться
hesitation = колебание; сомнение; нерешительность; неохота
heterogeneous = разнородный; гетерогенный; различный; неоднородный; разноплановый
heterogenous = гетерогенный; неоднородный; чужеродный; инородный
heuristic = нестрогий; приближенный; эвристический; способствующий
heuristics = эвристические правила; эвристика; эвристическая процедура; эвристическое правило
heyday = зенит; расцвет; лучшая пора
hibernate = гибернация; зимовать; проводить зиму в тёплых краях; бездействовать; быть в бездействии
highlight = указывать на; отличать; сделать упор; выделить
hilarious = веселый; смешной
hinder = мешать; воспрепятствовать; быть помехой; задержать; затруднять
hinge = зависеть; висеть; вращаться на петлях; зависеть от; прикреплять; прикреплять на петлях
hint = намёк; совет; очень маленькое количество; налёт; оттенок
hoax = ложь; неправда; фальшивка
hoisting = поднять; водружать; выкидывать; втаскивать
holistic = целостный; всеобъемлющий; всесторонний
homogenous = гомогенный; однородный; возникающий естественным путём
honest = честный; правдивый; прямой; искренний; откровенный; верный
host = хозяин; трактирщик; множество; толпа
hostile = неприятельский; вражеский; враждебный
humble = смирять; унижать; принижать; посрамлять; малый; не выдающийся
humbly = скромно; застенчиво; робко; смиренно; почтительно; покорно; бедно; незаметно; униженно
humungous = огромный; невероятный
hype = подстёгивание; подкрепление; оживление; обман; надувательство; рекламная шумиха
hypersonic = сверхзвуковой; ультразвуковой; гиперзвуковой
hyphen = дефис; соединительная чёрточка; чёрточка; символ переноса
idempotent = идемпотентный; не меняющий объект
identity = тождественность; идентичность; тождество; подлинность; личность; отличительные черты
idiomatic = идиоматический; характерный для данного языка; разговорный
idle = бездельничать; лодырничать; лениться; работать вхолостую
ill = зло; вред; невзгоды; беды
illicit = противоправный; недозволенный; запрещённый; тайный; преступный; неправедный
illness = нездоровье; болезнь; недуг
immediately = немедленно; тотчас; непосредственно; тотчас же; как только
immensely = чрезвычайно; в огромной степени; необычайно; безмерно; в большой степени; весьма; очень
immutable = неизменный; непреложный; вездесущий; незыблемый
impedes = препятствовать; затруднять; задерживать; мешать
imperative = обязанность; долг; приказ; приказание; требование; настоятельная необходимость
impersonator = имитатор; изображающий; пародист
implication = вовлечение; впутывание; причастность; соучастие; смысл; значение
implicit = подразумеваемый; не выраженный прямо; скрытый
imply = подразумевать; предполагать; означать; намекать; давать понять; заключать в себе; значить
impose = облагать; налагать; возлагать; навязывать; обманывать
impression = впечатление; отпечаток
in a sense = отчасти; в некотором роде; в определенной степени; в какой-то мере; в известной мере; некоторым образом; не без основания
inability = неспособность; невозможность; несостоятельность; отсутствие возможности
inaccessible = недоступный; недосягаемый; неприступный; замкнутый; сдержанный; малодоступный
inadvertently = непреднамеренно; без умысла; по недосмотру; случайно; невольно
incentive = побудительный; стимулирующий; вдохновляющий
incessantly = непрерывно; непрестанно; бесконечно; постоянно; без умолку
incidentally = случайно; между прочим; в этой связи; кстати; в связи с этим; несущественно; в данном случае; мимоходом
inclination = наклонение; наклон; уклон; склон; откос; скат; склонность
incline = наклонять; нагибать; склонять
inclined = склонный; наклонный; отклоняющийся
inconsistency = несовместимость; противоречивость; несообразность; непоследовательность; сбивчивость
inconsistent = несовместимый; непоследовательный; противоречивый; неустойчивый; изменчивый; непостоянный; несоответствующий
incorporate = включить; соединять; объединять; соединяться; объединяться
increasingly = всё больше и больше; всё более; всё чаще; все масштабнее
incur = подвергаться; навлечь; наделать; нести; навлекать; причинить
incurring = навлекать на себя; подвергаться; подвергнуться; потерпеть; навлечь; наделать
indefinitely = неопределённо; неясно; необоснованно; бессрочно
indeterminacy = неопределённость; неопределимость; двусмысленность
indicative = указывающий; показывающий; свидетельствующий; характерный
indice = индикатор; показатель; индексы; указатель
indirection = косвенность; обход; побочность; косвенная адресация
indirectly = непрямо; косвенно; из третьих рук
indistinguishable = неразличимый; незаметный; неотличимый
indorse = одобрять; подтвердить; расписываться
inevitable = неизбежный; неминуемый; неизменный; верный; неотвратимый; предопределённый
inevitably = неизбежный; неминуемый; неизменный; неизбежно; неминуемо; как следствие
infeasible = невыполнимая задача; неподходящий; невозможный; недопустимый; нереализуемый
infer = заключать; означать; подразумевать; делать вывод
inference = вывод; заключение; выведение; предположение; подразумеваемое; следствие; версия
inferiority = неполноценность; низкое качество; низшая степень
inferred = подразумеваемый; предположительный; логически выводимый
infest = наводнять; осаждать; нападать; паразитировать; кишеть; заполнять
influence = влияние; воздействие; фактор влияния; авторитет
influx = наплыв; втекание; приток; прилив
informal = неофициальный; неформальный; не по форме; непринуждённый
inhabitant = житель; обитатель; обыватель
inherently = по своему существу; в своей основе; от природы; по существу; по сути
inherit = наследовать; унаследовать; перенять
inheritance = наследование; унаследование; наследство; наследие; наследственность
inhibit = препятствовать; сдерживать; подавлять; сдержать; подавить; воспрепятствовать; задерживать; налагать запрет
initial = начальный; первоначальный; исходный; предварительный; первый
initially = первоначально; вначале; исходно; первично
innovative = новаторский; рационализаторский; передовой; инновационный; оригинальный
inroad = набег; нашествие; вторжение; нападение
insidious = хитрый; вероломный; коварный; предательский; незаметно подкрадывающийся; действующий втайне
insight = понимание; догадка; озарение; проникновение в суть
insofar = постольку; до такой степени; в такой мере
inspiration = вдохновение; воодушевление; побуждение
inspire = внушить; вселить; пробудить; воодушевлять
instantiable = допускающий создание экземпляров; инстанцируемый
instantiate = создать экземпляр; характеризовать; подтверждать примерами; иллюстрировать примерами
instead = вместо; взамен; зато; наоборот; между тем; напротив; на самом деле
instrument = реализовать; практически осуществить; орудие; инструмент; прибор
instrumentation = приборостроение; оборудование инструментами; пользование приборами; измерительный
insufficient = недостаточный; несоответствующий; неудовлетворительный; непригодный
insulate = отделять; обособлять; ограждать
insulation = изоляция; обособление; обособленность
intact = неповреждённый; невредимый; целый; нетронутый; исправный
integral = неотъемлемый; существенный; всеобъемлющий; интегральный; целостный
intelligible = понятный; вразумительный; ясный; чёткий; внятный
intend = подразумевать; предназначать; намереваться; предполагать; хотеть; иметь в виду
intent = намерение; цель; предназначение; умысел; желание
intention = намерение; умысел; стремление; цель; значение; смысл; замысел; мысль; расчёт
intentionally = намеренно
interaction = взаимодействие; обмен данными; взаимовлияние
intercept = перехват; захват
interception = перехват; заграждение; задержание
interchange = заменять; переставлять; обмениваться; чередовать; сменять
interchangeable = взаимозаменяемость; чередующийся; равноценный
interconnect = связывать; связать; взаимосвязывать
interfere = мешать; чинить препятствия; вредить; портить; надоедать; докучать
interlace = переплетать; сплетать; соединять; схлёстывать
interleaved = перемежать; чередовать; прослаивать
interlink = связующее звено; связывать; увязывать; сцепить
intermediary = посреднический; промежуточный
intermediate = промежуточный; переходный; вспомогательный; средний; посреднический; смешанный
intermittent = прерывающийся; прерывистый; периодический; прекращающийся; останавливающийся
intermixed = смешивать; перемешивать; смешиваться; перемешиваться; сливаться; соединяться
intern = изолировать; задерживать; стажироваться
internalize = усваивать; перенимать; впитывать
internally = изнутри; с внутренней стороны; внутри; внутренне
interoperability = взаимная согласованность; взаимозаменяемость; совместимость
interoperable = межоперационный; взаимодействующий; обеспечивающий взаимодействие; совместимый
interoperably = обеспечивающий взаимодействие; интероперабельный; взаимозаменяемый; совместимый
interoperate = взаимодействовать; быть совместимым
intersection = перекрёсток; перекрёсток; точка пересечения; линия пересечения; скрещение
intervene = вмешиваться; вступаться; посредничать; находиться; лежать между
intimidate = пугать; запугивать; угрожать; устрашать; шантажировать; запугать
intitule = давать право; величать; давать название; называть; титуловать; уполномочить
intramodular = внутримодульный
intricate = запутанный; сложный; замысловатый; затруднительный; мудрёный
intriguing = интриговать; вести интриги; строить козни
intrinsically = в действительности; по сути; по существу; от природы; в сущности; свойственно; объективно; сам по себе
introspection = рефлексия
inundate = затоплять; наводнять; наполнять; наполнить; засыпать
invariant = неизменяющийся; постоянный; инвариантный
invent = изобретать; создавать; выдумывать; придумывать; сочинять
inventive = изобретательный; находчивый; затейливый
inventiveness = изобретательность; находчивость; изобретательство; выдумка
invite = приглашать; звать
invocation = привлечение; запуск; инициирование
invoke = вызывать; задействовать; призывать; взывать; молить; обращаться к
involve = включать; содержать; подразумевать; предполагать; вовлекать
involved = сложный; запутанный; рассматриваемый; данный; имеющий место; встречающийся; включённый; задействованный
invulnerable = неуязвимый; неприступный; неопровержимый
ironclad = бронированный; твёрдый; нерушимый; жёсткий; броненосный
irrelevant = не имеет значения; неуместный; неподходящий
irritate = раздражать; сердить; растравлять; злить; бередить
issue = предмет обсуждения; спорный вопрос; издание; выпускать; издавать
issues = ограничения; нежелательные последствия; проблемы
itch = зуд; чесотка; непреодолимое желани; жажда; стремление; вожделение
jeopardy = подвергать опасности; рисковать; ставить под удар
judiciously = осмысленно; с осторожностью; продуманно; взвешенно; рационально; разумно; рассудительно; благоразумно
jumble = смешивать; перемешивать; смешиваться; перемешиваться; путать; сбивать с толку; взбалтывать
juncture = стык; соединение
junk = утиль; барахло; джонка; старьё; ненужный хлам; тряпье
keenly = тонко; проницательно; внимательно; живо; с интересом
keister = задний карман джинсов; задница; кейс; сейф; дорожная сумка; надёжный ящик; саквояж; сундук; чемодан; женский лобок; ягодицы
kindness = доброта; сердечность; любезность; благожелательность; одолжение; услуга; благодушие; милость
lack = недостаток; нехватка; отсутствие; нужда; недоделка
landfill = полигон; свалка
large-scale = крупномасштабный
lasting = длительность; продолжительность; прочность
lastly = на последнем месте; в конце; в заключение; под конец, наконец; заключение; в конце концов; в последнюю очередь
latch = щеколда; запор; задвижка; защёлка; захват
latency = скрытность; задержка
latter = недавний; более поздний; последний
layout = показ; выставка; планировка; проект; облик; внешний вид; устройство; cхема; разметка; способ размещения
leaf = лист; листва; страница
leaky = протекающий; неплотный; дырявый
lean = опираться; полагаться; нагибаться; сгибаться; наклонять; упираться
leaves = листья; страницы
legitimately = с полным основанием; оправданно; законно; правильно; по праву
lengthy = слишком длинный; растянутый; длительный; затяжной; высокий
lest = как бы не; чтобы; во избежание
letdown = ослабление; замедление; падение; ухудшение; недостаток; отрицательная сторона; разочарование; обман; неоправдавшееся ожидание; спад
leverage = максимально использовать; пользоваться; использовать; эксплуатировать; применять; выигрывать; иметь преимущество
leverages = усилие рычага; выигрыш в силе; рычаг; двигатель; подъёмная сила
liaison = связывающий; связной; связующий; соединение
lifespan = продолжительность; срок жизни
lifing = увеличение наработки на отказ; продление жизненного цикла изделия
likelihood = вероятность; правдоподобие; возможность
linger = задерживаться; засиживаться; ещё удерживаться; медлить; мешкать
literally = буквально; дословно; точно; без преувеличений; в соответствии с фактами; слово в слово; в прямом смысле
litmus = лакмусовый; лакмус
litter = засорять; мусор
littere = сорить; мусорить; набрасывать; делать беспорядок
lockstep = негибкий; непреклонный; шаг в ногу; строгая система, порядок
lofty = очень высокий; возвышенный; высокий; высокомерный; надменный
longterm = долгосрочный; длительный; многолетний; постоянный
lookup = поиск; просмотр; опрос; подстановка; преобразование
lurk = скрываться в засаде; таиться; оставаться; тайно угрожать; прятаться; скрываться
magnified = увеличивать; преувеличивать; восхвалять; раздувать
magnitude = величина; размеры; важность; значительность; параметры
maintain = сохранять; содержать; защищать; отстаивать; поддержать; удержать
maintenance = сохранение, поддержание
malform = деформировать
malicious = злобный; злой; злонамеренный; злодейский; злостный; тёмный
mandate = распоряжение; предписание; требование
mandatory = доверенный; уполномоченный; мандатный; обязательный
manifest = декларация; заявление; манифестация; обнародование; обнаружение
marginally = немного; в небольшой степени; вскользь; слегка; малость
marmot = сурок; байбак; пизда
marshaler = сигнальщик
marshaling = трансляция и передача параметров; сортировка; сосредоточение войск
mashup = неоднородный контент; окрошка; солянка технологий
mastering = справляться; одолевать; подчинять себе; преодолевать; овладевать
matchup = противоборство; противостояние; встреча
matter = вещество; материал; содержание; сущность; предмет; дело; значить; стоить
mature = созреть; вполне развиться; разрабатывать; совершенствовать; отрабатывать; доводить до зрелости
maxim = поговорка; принцип; завет; изречение; аксиома
meaningful = важный; значимый; многозначительный; выразительный; целенаправленный
measurable = значительный; измеримый; заметный; ощутимый; не особенно большой; умеренный
measure = мера; измерение; замер
media = средство; способ; среда; носитель информации
mediocrity = посредственность; заурядность; убожество
meet = достигать; встречаться
mental = мысленный; психический; сознательный; производимый в уме
mention = упомянуть; ссылаться; обмолвиться
mere = сам по себе; просто-напросто; исключительно; всего-навсего; простой; чистый; единственный; всего лишь; сущий; настоящий
merely = только; просто; единственно; лишь; всего-навсего; всего лишь
merit = заслуга; достоинство; заслуживать; критерий; показатель; характеристика
mersenne = число мерсенна
midst = среди; посреди; между; средь
milestone = мильный камень; мильный столб; этап работ; момент
mimic = пародировать; подделывать; передразнить
mindless = глупый; бессмысленный; бестолковый; безмозглый; не думающий
mingle = мешанина; смесь; смешивать; сливаться; скрещиваться; тусоваться; вращаться в обществе
minor = второстепенный; меньший из двух; меньший; младший; умеренный; незначительный
minutia = мелкая или незначительная деталь; мелочь; подробность; незначительная деталь (pl. -ae trix); частность
misbehave = дурно вести себя; хулиганить; неправильно функционировать; давать сбои
miscellaneous = разное; прочее
misconception = неправильное понимание; недоразумение; ложное представление
misconstrue = неправильно истолковывать; неправильно истолковать; превратно понимать; извратить
misconstrued = извращённый
misguide = неправильно направлять; вводить в заблуждение; дурно обращаться; испортить; сбить с курса
mishandle = плохо обращаться; плохо управлять; неправильно обращаться; испортить
mislead = вводить в заблуждение; обманывать; сбивать с пути; развращать
mismatch = плохое сочетание; несоответствие; дисбаланс; нестыковка
misplace = положить не на место; потерять; затерять
misspell = делать орфографическую ошибку; орфографическая ошибка; опечатка; ошибка в написании
misuse = неправильное использование, плохое обращение
mixture = смесь; смешивание; состав; микстура
mock = подражать; подделка; имитировать
modest = скромный; сдержанный; благопристойный; умеренный; небогатый; благонравный
modular = блочный; сборный; беззнаковый
molesting = приставать; досаждать; нападать; привязываться
momentous = важный; имеющий важное значение; важнейший, исключительной важности; судьбоносный
mood = настроение; расположение духа; тон; капризы; наклонение грамматическое; лад
motto = девиз; лозунг; изречение
mount = взбираться; восходить; подниматься; устанавливать; ставить на возвышении
mouthful = кусок; глоток; важное заявление
mowing the lawn = стрижка газона
muck = навоз; навозная жижа; перегной; гумус; гнев; дрянь; мерзость
mug = кружка; отвратительная личность; дурак; фотография
multiset = мультимножество; множество с повторяющимися элементами
multitude = большое число; масса; толпа; многообразие; множество
mundane = земной; светский; мирской; бытовой; неприметный; весьма обычный; простой
mutually = взаимно; обоюдно; совместно; сообща
myriad = несметное число; мириады; десять тысяч; бесчисленное множество
narrate = рассказывать; повествовать
narrative = рассказ; изложение; повествование
narrator = рассказчик; повествователь; вещатель
narrow = узкий; суживать; уменьшать
native = родной; туземный; местный; самородный; естественный; прирождённый
naturally = естественно; свободно; легко; по природе; от рождения
neat = чистый; чистоплотный; опрятный; аккуратный; стройный; чёткий; ясный; лаконичный
necessity = необходимость; нужда; неизбежность; бедность; нищета; надобность; обязательность
needle = игла; шить; прокалывать
needlessly = напрасно; без нужды; без необходимости
nefarious = гнусный; мерзкий; подлый; нечестивый; бесчестный
negate = отвергать; отменять; отрицать; выполнять операцию не
neglect = пренебрегать; не заботиться; упускать; не обращать внимания
neglectful = небрежный; нерадивый; беззаботный
negligible = ничтожный; не принимаемый в расчёт; мелкий; незначительный; пренебрежимый
negotiating = договариваться; обсудить условия; устраивать; улаживать
nest = вить гнездо; гнездиться
nested = сцепленный; вложенный; составной
niceness = уступчивость; благопристойность; миловидность; любезность
nicety = точность; пунктуальность; тщательность; осторожность; утончённость
niche = убежище; ниша; надлежащее место
niece = племянница
nifty = модный; щегольской; стильный; отличный; изящный
ninety = девяносто; девяносто лет
no-brainer = элементарно; проще некуда; простак; недалёкий человек
no-nonsense = серьёзный; деловой; нешуточный; строгий; прагматичный
no-op = холостая команда; пустая операция; фиктивная команда
nonsensical = бессмысленный; нелепый; глупый; абсурдный; безумный
noop = холостая команда; пустая операция; фиктивная команда
nostril = ноздря
notation = нотация; изображение условными знаками; запись; описание
notch = метка; зазубрина; бороздка; желобок; утор; зубец
noteworthy = примечателно
noticeably = заметно; значительно
notion = понятие; взгляд; мнение; точка зрения
notoriously = общеизвестно; печально известно; откровенно
notwithstanding = хотя; несмотря на то; несмотря на; вопреки; тем не менее; однако; всё же; и все-таки; несмотря на то, что; независимо от
noun = имя существительное; субстантив
nowhere = нигде
numb = онемелый; оцепенелый; окоченелый
numerous = многочисленный; обширный; многократный; кишащий; целый ряд; множество; неоднократный
nutrition = питание; пища; питательность
obfuscate = сбить с толку; затуманить рассудок; путать
obligate = обязать; предписать; заставлять; принуждать
obliterates = уничтожать; вычёркивать; стирать
oblivious = забывчивый; забывающий; не помнящий; непомнящий
obscure = тёмный; слабо освещённый; мрачный; неясный; смутный; непонятный; невразумительный; неразборчивый; незаметный
obsess = завладевать умом; преследовать; мучить; вселяться; завладеть
obsolete = устарелый; старомодный; отживший; изношенный; обветшалый; атрофированный; остаточный; устаревший
obtain = получать; добавлять
occasion = случай; событие; возможность; основание; причина; повод; обстоятельство
occur = случаться; происходить; встречаться; попадаться; участвовать; возникать
occurrence = случай; явление; происшествие; частотность; событие; вхождение; наличие
octet = октет; восьмёрка; восьмибитовый слог; октада; байт
odd = непарная вещь; нечётное число; странность; случайность; фора
oddity = странность; непонятность; чудаковатость; чудак; причудливая вещь; оказия; диковинка
odds = расклад; возможность; шансы
offensive = оскорбительный; неприятный; противный; отвратительный; наступательный
offer = предлагать; пытаться; пробовать
omit = пренебречь; пропускать; не включать; обойтись
onion = луковица; лук
onto = на; к; в; поблизости; около; отношение к; приближение к; сравнение с
opaque = непрозрачный; светонепроницаемый; непроницаемый; тёмный; тупой; глупый; закулисны
opinionated = самоуверенный; упрямый; своевольный; категоричный
oppose = противиться; сопротивляться; быть против; бороться; препятствовать; мешать
opt = выбирать; делать выбор; предпочитать; выбрать
ordinary = обыкновенный; ординарный; повседневный; простой; заурядный; посредственный; банальный
originally = первоначально; исходно; поначалу; по происхождению; оригинально; сначала; впервые
originate = давать начало, порождать; происходить
orthogonal = прямоугольный; перпендикулярный; самостоятельный
ought = быть в долгу; быть обязанным; приказывать; подобать; приказать; подобает
outcome = результат; последствие; исход
outfit = оборудовать; снаряжать; экипировать; снабжать; снаряжение; экипировка; оборудование
outfitted = оснащённый, оборудованный; в комплектации
outgrow = перерастать; вырастать; избавляться с возрастом
outline = набросок; эскиз; план; конспект; схема; очерк; контур; канва; начертание
outlived = пережить; перенести; выжить; переживать; изжить себя; устаревать; устареть; хоронить
outperform = превосходить; превзойти; превышать; опережать
outright = прямой; открытый; совершенный; полный; недвусмысленный; полностью
outset = начало; начальный этап; отправление
outstanding = выдающийся; знаменитый; выступающий; неуплаченный; просроченный; непроданный
outward = внешний; наружный; наружу; видимый
overburden = перегрузка; перегружать; отягощать
overcome = преодолеть; побороть; победить; превозмочь
overdo = заходить слишком далеко; переборщить; перестараться; переусердствовать; утрировать; преувеличивать; пережаривать; переваривать
overflow = переполнение; разлив; наводнение; избыток
overhead = непроизводительные затраты; верхний; высокий; наверху; над головой
overlap = совпадение; перекрытие; нахлёстка; частичное совпадение; взаимное наложение
overlook = возвышаться; смотреть сверху на; обозревать; смотреть за; надзирать; следить
overlooked = упускаемый из виду; незамеченный
overridde = переопределять; перехватить
overrode = отвергать; задавить; попирать; топтать; переехать; попрать; отвергнуть; брать верх; перевешивать
oversight = недосмотр; оплошность; присмотр; просмотр; упущение; контроль; надзор
overstate = преувеличивать; преувеличить; завышать; драматизировать
owe = быть должным; задолжать; быть обязанным
pace = шаг; длина шага; скорость; походка; поступь
pagination = нумерация страниц; пагинация; число страниц; разбивка
paging = нумеровать страницы; прислуживать
painstakingly = дотошно; скрупулёзно; методично; шаг за шагом
pallid = бледный; мертвенно-бледный; ни кровинки; жухлый; скучный
par = нарицательная; номинальная цена; номинал
paramount = первостепенный; верховный; высший; первой важности; главенствующий
paraphrasing = пересказывать; пересказать; зашифровывать; расшифровывать; перефразировывать
parentheses = вставной эпизод; интервал; предложение; круглая скобка; скобка
participant = участник; принимающий участие; соучастник
participate = принимать участие; участвовать
participated = участвовать; принимать участие; разделять
participating = участвующий
participation = участие; соучастие; привлечение
particular = специфический; индивидуальный; особый
particularly = чрезвычайно; особенно; подробно
parties = партии; участники; соперники; стороны
partition = раздел; разделение; расчленение; часть; подразделение; отделение; переборка; перегородка; загородка; деление; ширма
partway = пройдя часть пути; отчасти; частично
passerby = прохожий
pave = мостить; выстилать; усеивать
payload = полезная нагрузка; полезный груз; полезные данные
payroll = платёжная ведомость; расчёты с персоналом
peculiarity = специфичность; особенность; характерная черта; отличительное качество; свойство; странность
peddle = заниматься пустяками; размениваться на мелочи; разносить; торговать мелким товаром
peek = взгляд украдкой; быстрый взгляд; беглый взгляд; проблеск; просвет
peer = ровня; пэр; одноранговые узлы; пир; равный; сверстник; референтный; партнёр; всматриваться; показываться; проглядывать; выглядывать
penalize = наказать; оштрафовать; ставить в невыгодное положение; навлекать кару; забраковать; наложить взыскание
penalty = наказание; взыскание; пенальти; расплата; штрафная неустойка
pend = ожидать; зависеть; откладывать решение
pending = в ожидании; рассматриваемый; находящийся на рассмотрении; нерешённый; незаконченный; во время
per = на; с; за; согласно; по; через; посредством; с помощью
perceive = понимать; осознавать; постигать; различать; ощущать
perception = восприятие; ощущение; осознание; понимание; сознание; познание
perennial = вечный; неувядаемый; многолетний; долговечный; непрерывный; круглогодичный
perform = исполнять; делать; представлять
permissible = позволительный; допустимый; безопасный
permit = позволять; разрешать; давать разрешение
perpetual = вечный; пожизненный; бессрочный; беспрестанный; непрекращающийся; цветущий круглый год
perpetuate = сохранять навсегда; увековечить; сохранить навсегда; закрепить
perseverance = терпение; упорство; настойчивость; стойкость; непоколебимость
persist = упорствовать; настойчиво продолжать; продолжать существовать; сохраняться
persistence = настойчивость; упорство; продолжительность
persistent = упорный; настойчивый; стойкий; сохраняемый; хранимый
persistently = целенаправленно; навязчиво; настойчиво; неотступно; упорно; постоянно
persuade = убеждать; склонять; уговаривать; вдавливать; втискивать; урезонивать
pertain = относиться; принадлежать; быть свойственным; подходить; подобать
pertinent = уместный; подходящий; имеющий отношение
pervasive = распространяющийся; проникающий; вездесущий
pesky = досадный; противный; скверный; настырный
petal = лепесток; лопасть
pile = свая; столб; кол; куча; груда; кипа
pin = прикалывать; скреплять; скалывать; пробивать; придавить; прижать
pinpoint = точно определять; указывать; засекать цель; засечь цель; указать точно
pitfall = волчья яма; трудность; опасность; ловушка
plague = беспокойство; беда; бедствие
plant = саженец; поза; позиция; завод; фабрика; предприятие; установка; оборудование
pledge = закладывать; отдавать в залог; заверять; ручаться
plentiful = обильный; изобильный; богатый; плодородный; с избытком; в избытке; избыточный
plenty = много; изрядно; достаток
plot = заговор; интрига; фабула; сюжет
plug = затыкать; закупоривать; законопачивать; пломбировать; вставлять
plumb = паять; подключить; напортить
plummeted = быстро падать; рухнуть; обрушиться; просесть; свинцовый груз; гирька; грузило
plural = множественное число
pointcut = срез точек соединения; срез кода; набор точек соединения
poke = совать; тыкать; толкать; пихать; идти ощупью
polish = полировать; шлифовать; наводить лоск
poll = опрос; проводить голосование; подрезать верхушку; срезать
polling = опрашивать; голосовать; подсчитывать голоса
pollute = загрязнять; осквернять; развращать; загрязнить
pollution = загрязнение; загрязнение окружающей среды; осквернение; засорённость
pong = хохмить; вонять; смердеть; нести отсебятину
pooled = обезличенный; единый; объединённый
pooling = объединяться в пул; вносить в общий фонд; складываться; сложиться; устраивать складчину
populate = заселять; населять; наполнять; загружать
portion = часть; доля; приданое; порция
pose = позировать; принимать позу; рисоваться; излагать; формулировать; предлагать; ставить; представлять собой; являться
possess = обладать; владеть; сохранять
possibility = возможность; вероятность; перспективы; вариант
postal = почтовый; открытка; чокнутый
posterity = потомство; последующие поколения; потомки; будущие поколения
posture = поза; положение; позиция; осанка
potent = сильный; могущественный; мощный; убедительный; сильнодействующий; крепкий
powder = порошок; пудра; порох; пыль; опушить; усилитель
practically = практически; фактически; на деле; в сущности; почти; на практике; практично
praise = похвала; восхваление; хвала; достоинство; заслуга
precautions = предосторожность; предусмотрительность; предостережение; превентивная мера
precedence = предшествование; первоочерёдность; предпочтение; старшинство; первенство
precedent = предшествующий; прежний; прецедент
preceding = предшествующий; предыдущий
precise = точный; определённый; аккуратный; тщательный
precision = точность; чёткость; аккуратность; пунктуальность
precludes = предотвращать; устранять; мешать; устранить; исключать заранее
predate = датировать задним; более ранним числом; произойти до
predecessor = предшественник
predicate = заявлять; наводить на мысль; объявлять; сказуемое; утверждение
predict = прогнозировать; пророчить; предсказать
predictable = предсказуемый; поддающийся оценке; ожидаемый
predictably = как и ожидалось; с уверенностью; как и можно было ожидать
predominate = преобладать; превалировать; превосходить; господствовать; возвышаться; царить
preempt = завладевать раньше других; упреждать; предупреждать
preexisting = более ранний; ранее существовавший
preference = предпочтение; преимущество; выбор
preliminary = предварительный; заблаговременный; вступительный; ориентировочный
premature = преждевременный; поспешный; непродуманный; безвременный; раньше срока
premise = предпосылка; замысел; исходное условие
prepend = добавлять к началу; перед именем
prepositions = предлог; установить на позиции
prescribe = предписывать; рекомендовать; задать
presence = наличие; существование; присутствие
preserve = сохранять; оберегать; хранить
preside = осуществлять контроль; осуществлять руководство; руководить; председательствовать
presumably = предположительно; по-видимому; возможно; вероятно; видимо; очевидно; приблизительно; надо полагать
presume = полагать; предполагать; допускать; позволять себе; злоупотреблять
prevalent = распространённый; превалирующий; преобладающий
prevent = не допустить
primarily = в первую очередь; главным образом; сначала; сперва; первоначально; прежде всего; первым делом
principal = субъект; поручитель; главный; основной; ведущий; целевой
proactively = упреждающе; предусмотрительно; на упреждение; активно; на опережение; в ускоренном режиме
probabilistic = вероятностный; вероятный
probability = вероятность; правдоподобность; правдоподобие; вероятие
probable = возможно; надо полагать; наверно; вероятно; как видно; по всей видимости
procurement = получение; закупки; снабжение; поставка
proficient = искусный; умелый; опытный; компетентный
programmatic = схематичный; программируемый
prolong = продлевать; продолжать; увеличивать в длину; отсрочить
prominence = выпуклость; неровность; возвышение; известность; бугорок; опухоль; выдающееся положение; признание
prominent = выступающий; торчащий; рельефный; видный; известный; выдающийся; значительный
promote = продвигать; способствовать; содействовать; поддерживать; поощрять; возбуждать; стимулировать; активизировать
prompt = подсказка; напоминание; приглашение; запрос; инструкция
promptly = оперативно; быстро; срочно; безотлагательно; точно; аккуратно; без промедления; незамедлительно
promptness = быстрота; отсутствие проволочки; готовность; проворство; своевременность; оперативность
prone = лежащий ничком; распростертый; имеющий наклон; покатый; наклонный; отвесный; крутой; обрывистый; склонный; имеющий тенденцию
pronunciation = произношение; выговор; фонетическая транскрипция; произнесение; выговаривание
propagate = размножать; разводить; распространить
propagation = размножение; проповедь; пропагандирование
proper = присущий; свойственный; правильный; надлежащий; должный
property = собственность; имущество; способность; характеристика
proponent = сторонник; защитник; поборник
proposal = проект; план; предложение; предположение
propose = предлагать; вносить предложение; предполагать
proposition = утверждение; заявление; предложение
proprietary = собственник; владелец; право собственности
prospect = исследовать; разведывать; провести изыскания; вид; панорама; перспектива; виды; планы на будущее
provide = обеспечивать; предусматривать; предоставлять
provision = снабжение; обеспечение; заготовление; положение; средство обеспечения
provoke = вызывать; возбуждать; провоцировать; сердить; раздражать
proximity = близость; соседство; вероятность; достижимость; приближённость; смежность
prune = обрезать; подрезать; сокращать; урезать; убирать; упрощать; удалять
pry = подглядывать; подсматривать; любопытствовать; выведывать; выпытывать
pull = тянуть; втягивать; откачивать
pun = каламбур; трамбовать
purchase = покупать; закупать; приобрести; получить; завоевать
purely = чисто; вполне; целиком; совершенно; исключительно; полностью; сугубо
purport = идея; пафос; свидетельствовать; замышлять
purpose = цель; замысел; результат; успех; целеустремлённость; воля; назначение; умысел; намерение
puzzledeal = замешательство; смущение; загадка; недоумение; озадаченность
puzzling = сбивающий с толку
quadratic = квадратный; квадратное уравнение; уравнение второй степени
qualify = определять; подготавливать; ослаблять; смягчать; разбавлять; обучать
quantity = количество; величина; множество; изобилие
queasy = щепетильный; деликатный; привередливый; разборчивый; прихотливый; тошнотворный
queue = очередь; хвост; анкета; ожидание
queuing = очередизация; организация очередей; простой в очереди
quite = вполне; совсем; совершенно; полностью; всецело; до некоторой степени; более или менее; довольно
racy = характерный; острый; живой; энергичный; яркий
raise = поднимать; повышать; подняться; вздымать
ransomware = программа-вымогатель; программы, требующие выкупа; вредоносная программа с требованием выкупа
rapid = быстрый; скорый; частый; стремительный; резкий; скоростной; бурный
rapt = восхищённый; увлечённый; похищенный; унесённый
rare = редкий; разрежённый; негустой; неплотный; исключительно; недожаренный
rate = исчислять; расценивать; рассматривать; отчитывать
rather = скорее; охотнее; правильнее; предпочтительно; лучше
raw = сырье; сырой; неочищенный
reactive = реагирующий; дающий реакцию; противодействующий; возвратный
readily = с готовностью; охотно; легко; быстро; без труда; с охотой
realize = осуществить; выполнить; реализовать; претворить в жизнь; представлять себе; понимать
realm = королевство; поименованная область; область действия; область
rearrange = поправлять; приводить в порядок; переставлять; передвигать; перестраивать
reasserts = переформулировать; подтверждать; снова выдвигать; заверять
reassign = назначать на другую должность; перераспределять; переопределять; переассигновать
recap = краткое перечисление; повторение вкратце; резюме; суммирование
receive = получать; принимать; воспринимать; вмещать
recent = недавний; последний; новый; свежий; современный; недалёкий
recently = недавно; на днях; в последнее время; за последнее время; намедни
reception = приём; принятие; получение; приём в члены; встреча; восприятие; гостиная; общая комната
recipe = рецепт; средство; способ
recipient = получатель; приёмник; принимающая сторона
reclaim = исправлять; переделывать к лучшему; вызывать возрождение; требовать обратно; утилизировать; переделывать; восстановить
reclamation = восстановление; исправление; улучшение; переделка; перевоспитание
reconsider = пересматривать; изменять; пересмотреть; переосмыслить
recover = получить обратно; возвращать себе; отвоёвывать; восстанавливать; выздоравливать; оправляться
rectify = исправлять; поправлять; выправлять; уточнять
reduce = сбавлять; уменьшать; сокращать; ослаблять
reduction = снижение; понижение; уменьшение; сокращение; превращение
redundant = избыточный; излишний; чрезмерный; лишний; пышный
redundantly = наверняка; чрезмерно; избыточно
reentrant = повторно входимый; повторно используемый
referral = направление; передача; рекомендация
refine = очищать; рафинировать; облагораживать; улучшать; вдаваться в тонкости; вносить улучшения
refrain = сдерживаться; удерживаться; воздерживаться
refresher = освежающий напиток; напоминание; памятка
regardless = не считаясь; независимо; нестоящий; как бы там ни было
reifiable = материализуемый
reification = воплощение; реификация; конкретизация
reify = материализовать; превращать в нечто конкретное; овеществлять
reinstate = востанавливать; приводить в порядок
reissue = переиздание; перепечатка
rejoice = радовать; радоваться; веселиться; праздновать; наслаждаться
rekindle = вновь зажечь; вновь разгореться; возобновить; возродить
relay = сменять; обеспечивать смену; сменить; обеспечить смену; передавать
relevance = уместность; важность; относимость; актуальность; полезность
relevant = уместный; имеющий отношение; соответственный; характерный; свойственный
reliability = надёжность; прочность; добросовестность; верность
reliable = надежный; прочный; заслуживающий доверия
reliably = надёжно; верно; доподлинно
relieve = облегчать; ослаблять; успокаивать; выручать
rely = полагаться; надеяться; доверять; зависеть; доверяться; опереться
remain = пребывать; остаться; находиться; сохранять
remainder = остаток; остатки; остальные; излишек
remaining = остальной; неистёкший; высиживание; остающийся
remedied = вылечивать; исправлять; исправить; пособлять; ликвидировать
remedy = вылечивать; исправить; пособлять
reminisce = предаваться воспоминаниям; предаться воспоминаниям; вспомнить прошлое; вспоминать прошлое; вспоминать; вспомнить
remiss = упущение; небрежный; вялый; слабый; нерадивый; растворённый; разгильдяй; невнимательный
render = воздавать; отдавать; платить; представлять; оказывать; исполнять; передавать; переводить
rendition = перевод; интерпретация
renewable = восстановимый; возобновляемый; заменяемый
repetitive = повторяемый; скучный; без конца повторяющийся
reply = отвечать; возражать; давать ответ
reprehensible = предосудительный; достойный порицания; неблагообразный
represent = изображать; представлять; разъяснять; олицетворять; символизировать
representative = представляющий; изображающий; символизирующий; характерный; представительский
requirement = потребность; требование; необходимое условие; условие
research = исследование; изучение; изыскание; тщательные поиски
resemble = походить; иметь сходство; напоминать; мало чем отличаться
reside = обитать; располагаться; принадлежать
resiliency = жизнеспособность; жизнерадостность; выносливость; отказоустойчивость
resilient = упругий; эластичный; живучий; жизнеспособный; выносливый
resolution = решительность; решимость; твёрдость; решение; резолюция; разложение
resolve = решать; разрешить; определиться с
resolver = преобразователь имен; резольвер; разрешитель
resort = прибегать; посещать; часто посещать; прибегнуть; обращаться; средство; прибежище
resorting = прибегая; обращение
respect = уважать; почитать; соблюдать; не нарушать; щадить; беречь; прислушиваться
respective = соответственный; относительный; соответствующий; связанный
respectively = соответственно; в указанном порядке
responsibility = обязанность; обязанности; порука; платёжеспособность
responsive = чуткий; отзывчивый; быстро реагирующий; откликающийся
restate = вновь заявлять; подтверждать; иначе формулировать; пересчитывать; вновь повторять; перефразирование
restrict = ограничивать; держать в пределах; запретить; сдерживать
resurrect = воскрешать; возрождать; выкапывать; воскресить; выкопать; восстанавливать
retail = розничная продажа; розница
retain = помнить; сохранить; удерживать
retard = замедлять; задерживать; задержать; замедлить; тормозить
retrofitted = оснащён; модифицирован
reveal = выявить; разоблачить; показать; обнаружить; изобличать
revenue = доход; государственные доходы; доходные статьи; годовой доход
revise = пересмотр; проверка; просмотр; сверка; сводка
revoke = отменять; аннулировать; брать назад
rewind = перематывать; перекрутить
rid = освобождать; избавлять; выплёвывать; очищать
rigid = жёсткий; негнущийся; неподвижный; неподвижно закреплённый; суровый; строгий; непреклонный; стойкий; косный; негибкий; твёрдый
rigorous = строгий; неумолимый; безжалостный; точный; тщательный; суровый; скрупулёзный; жестокий
rigourous = строгий; суровый; неумолимый; неукоснительный
rinse = полоскать; промывать; сплюнуть
robust = крепкий; здравый; надёжный; устойчивый
rogue = злой; блатной; плутовской; не поддающийся контролю; жулик; мошенник
rooted = имеющий корни; с корнями; укоренившийся
rotate = двигать по кругу; повернуться; вращаться; чередоваться; сменяться по очереди; сменять; кружить
rough = трудный; неровный; шероховатый; черновой
roughly = примерно; грубо; невежливо; начерно; округленно; ориентировочно; приближённо; шершаво
route = маршрут; курс
rubble = булыжник; рваный камень; валун; руины
rummage = рыться; искать; обыскивать; рассматривать; тщательно исследовать
safely = с уверенностью; без колебаний; благополучно; надёжно; безопасно
sake = ради; для
salary = жалованье; заработная плата служащего; заработная плата; содержание
sappy = сочный; в соку; молодой; полный сил; живой; энергичный; сильный
saturate = пропитывать; промачивать; пронизывать; насыщать; подавлять
scaffolding = подмости; строительные леса; помост; эстакада; временные платформы
scalability = масштабируемость; расщепляемость
scalable = эластичный; масштабируемый; расширяемый
scalar = скаляр; шкала; масштаб; скалярная величина
scammer = обманщик; кидала; напёрсточник; мошенник; жулик
scatter = рассеивать; разбрасывать; рассыпать; раскидывать
schedule = список; каталог; опись; программа; инвентарь; план; таблица
scheduled = запланированный; регулярный; ожидаемый; по графику; по плану; программный
scheduler = диспетчер; планировщик
scoot = смываться; срываться с места; стремительный бег; бежать стремглав; отправлять; пересылать; драпать; подвинуться; скользить
scope = пределы; рамки; границы; масштаб; размах; сфера; поле
scrap = ссора; лом; кусок; лоскут; вырезка; утильсырьё; пустое обещание
scrimp = экономить; скупиться; урезать; скудный; недостаточный
seamlessly = незаметно для пользователя; связно; последовательно; органично
seasoned = закалённый; опытный; матёрый; маститый; искушённый; прожжённый
seclusion = уединение; изоляция; заключение; одиночество; уединённое место
securely = спокойно; в безопасности; ничего не опасаясь; в надежном месте; безопасно
seduced = соблазнить; обольстить; совратить; заманивать
seemingly = по внешнему виду; на вид; вроде бы; казалось бы; судя по виду; кажется
segregate = отделять; выделять; изолировать
seize = хватать; схватить; поймать; захватывать; завладевать; конфисковать; воспользоваться
seldom = редко; нечасто; изредка; редкий
semicolon = точка с запятой
sense = чувство; ощущение; восприятие; сознание; рассудок; разум; здравый смысл; значение
sensible = разумный; благоразумный; здравомыслящий; ощутимый; заметный; чувствующий
sentence = приговаривать; осуждать; обречь; суждение; фраза
serializable = упорядочиваемый; преобразуемый в последовательную форму; серийно производимый; сериализуемый
serialize = преобразовывать; упорядочивать; публиковать
serpent = змея подколодная; змей; коварный человек; дьявол; предатель
settle = принимать решение; поселяться; обосновываться; поселять; устраиваться; усаживаться; укладываться
severe = строгий; суровый; жёсткий; тщательный; простой
severely = строго; сурово; опасно; чрезвычайно; существенно; скрупулёзно; резко
shape = контур; профиль; придавать форму
share = доля; часть; делиться
shift = перемещение; перестановка; перенос; перемена; смена
shift gears = переключать передачу; переключать скорость; сменить тему; перевести разговор; менять тактику
shifting = перемещать; передвигать; перекладывать
shortage = нехватка; недостаток; дефицит; недостача; недобор
shortcoming = недостаток; несовершенство; изъян; слабое место
shortcut = лёгкий путь; короткий путь
shoulder = плечо; лопатка; вешалка; обочина; откос
shout = кричать; громко говорить; выкрикивать; громко произносить; звать; окликать; закричать; покрикивать
shove = совать; толкать
shrink = сжиматься; сокращать; пересыхать; усыхать; сократить; сморщивать; сморщить
shuffle = шаркать; волочить ноги; хитрить; перемешивать; ёрзать; волочить
sibling = родной брат
sift = просеивать; просеять; отсеивать
sightings = наблюдение; прицеливание; случай наблюдения
signature = признак; ключ; подписывать
significance = значение; смысл; важность; значительность
significant = знаменательный; важный; показательный; существенный; многозначительный
significantly = значительно; в немалой степени; что особенно важно; выразительно; важно отметить, что; немаловажно
signify = означать; показывать; выражать; предвещать; значить
signum = знак; сигнум
silly = неумный; неразумный; глупый; слабоумный
simplify = упрощать; рационализировать; облегчить
simplistic = упрощенческий; незамысловатый; банальный; бесхитростный
simultaneity = одновременность; совместность; совмещение операций
simultaneously = одновременно; синхронно; совместно; единовременно
since = после; тому назад; постольку поскольку; начиная с; коль скоро; с тех пор
sincelery = искренне; неподдельно; с уважением; чистосердечно; бесхитростно
singularly = необыкновенно; особенно; единолично
sinister = дурной; зловещий; мрачный; нечестный; тёмный; низменный; злополучный
sitcom = дешёвый сериал; телевизионное комедийное шоу
sku = код товара; артикул
slavishly = слепо; рабски; раболепно
slick = скользкий
slid = скользить; поскользнуться; вдвигать; задвигать; обходить
slight = пренебрежение; игнорирование
slightly = мало; незначительно; слегка; еле-еле
slim = тонкий; стройный; несущественный; неубедительный; шаткий; хитрый; ловкий; слабый; лёгкий
slippery = скользкий; гладкий; увёртливый; ненадёжный
slope = уклон; покатость; наклон; склон; скат
sloppy = мокрый; сырой; неряшливый; замызганный
slosh = плескаться; пролить; хлюпать
smidge = малость; чуть-чуть
snappy = придирчивый; раздражительный; живой; энергичный; щегольской; моментальный; мгновенный
snide = фальшивый; нечестный; мошеннический; низкий; подлый; поддельный
snippet = отрывок
soar = парить; летать; взлетать; возвышаться; выситься
sober = отрезвлять; приводить в чувство; протрезвляться; трезвый; воздержанный; умеренный
socket = впадина; углубление; паз; патрон; держатель
sodium = натрий
sojourn = временное пребывание
sole = единственный; одиночный; исключительный; единоличный; уединённый; один; одинокий
solely = единственно; только; исключительно; исключительный; единолично
solitude = уединение; одиночество; "пустыня"; захолустье; глушь; уединённое место; заброшенное место; заброшенность; забытое место
somewhat = что-то; кое-что; слегка; весьма
sophisticated = утонченный; изощрённый; искушённый; сложный
sore = болячка; язва; нарыв; рана; воспаление; ожог; больное место
source = источник; первопричина
spanning = охват; натягивание; охватить
spare = беречь; сберегать; жалеть; экономить
sparingly = умеренно; в небольших количествах; эпизодически; с осторожностью; экономно
spawn = плодиться; размножаться; зарождаться; плодить; порождать
specifically = например; более того; конкретно; особенно; специально
specify = устанавливать; оговаривать; определять
specimen = образец; экземпляр; проба
specious = обманчивый; показной; кажущийся; лицемерный; благовидный
spine = сердцевина дерева; основа; суть; корешок книги; сущность
spite = злоба; озлобленность; враждебность; неприязнь; ехидство
splice = сращивать; сплетать; женить
spoof = мистифицировать; обманывать; обмануть; разыгрывать
spooky = жуткий; призрак; чудик
spot = клякса; пятнышко; место; уголок
spottily = пятнистый; замараный
spouse = супруг; супруга; устроить брак; сочетаться браком
sprinkle = обрызгивание; окропление; небольшое количество; капля
sprinkling = распрыскивание; окропление; посыпание; мелкий дождик
sprout = пускать ростки; давать побеги; распускаться; расти; вырастать; выращивать; проращивать; прорастать
spurious = поддельный; подложный; ложный; незаконнорождённый; туманный
squash = толпа; давка; плюх; шлёп; кабачок
squint = косоглазие; взгляд искоса; щуриться
stab = вонзать; колоть; ранить; тыкать; нанести удар; нападать
stack = стог; куча; груда; стек
stake = провешивать; кол; столб; стойка
stale = несвежий; чёрствый; выдохшийся
stance = поза; положение; отношение
standardize = нормировать; калибровать; унифицировать; аттестовать; градуировать; нормализовать; поверять; эталонировать
standpoint = точка зрения; позиция
starters = холодные закуски
starvation = голод; голодание; голодная смерть
stash = тайник; тайный запас; притон
statement = высказывание; изложение; заявление; утверждение; декларация; формулировка
steadfast = постоянный; прочный; устойчивый; непоколебимый; стойкий; твёрдый
steadily = неотрывно; уверенно; размеренно; монотонно; пристально
stem = стержень; род; племя; основа
stipulate = обусловливать; ставить условием; устанавливать; оговаривать; предусматривать
stomp = топать, топтать
storied = легендарный; украшенный историческими сюжетами; воспетый в легендах; имеющий этажи; известный по преданиям
straightforward = идейно простой; не вызывающий затруднений; прямой
strangely = странно; необычно; необыкновенно
stray = заблудиться; отбиться; отклоняться; блуждать
streamline = организовывать; упрощать; направление течения; линия обтекания; обтекаемая форма
streamlined = обтекаемый; хорошо налаженный; стройный; изящный
stretch = растягивать; удлинять; тянуть; натягивать; напрягать; простираться; иметь протяжение
strictly = строго; точно; сугубо
striking = поразительный; изумительный; необыкновенный; выдающийся; замечательный
strikingly = поразительно; удивительно; замечательно; внушительно; живо
strive = стремиться; порваться; порываться; бороться
struggle = борьба; трудность; проблемы
strut = подкос; распорка; элемент конструкции
stub = заглушка, пень
stubbing = корчевание; выкорчёвывание; раскорчёвка
stuff = материал; вещество; вещи; имущество; дрянь; чепуха; хлам; продукт
stumble = спотыкаться; оступаться; ставить подножку; ковылять; запинаться
stung = тот, кому продали некачественный товар; оставшийся у разбитого корыта; оплачивающий чужие счета; отвечающий за чужие грехи
stutter = запинаться; говорить неуверенно; запнуться
stymie = безвыходное положение; тупик; загонять в угол; поставить в тупик; мешать; заблокировать; сорвать
submit = отправить; предложить; внести
subsequent = последующий; более поздний; подчинённый; повторный
subsequently = впоследствии; затем; потом; далее; позднее; как следствие; соответственно
subservient = раболепный; подобострастный; служащий средством; содействующий; полезный; подчинённый; служебный; угодливый
substantial = существенный; важный; значительный; по сути; по существу; прочный; крепкий; солидный; питательный
substantially = по существу; в основном; значительно; по сути; в целом; главным образом; значительно
substitute = заместитель; замена; заменитель; суррогат
substitution = замена; подмена; замещение
subtle = тонкий; нежный; проницательный; трудно уловимый; едва различимый
subtract = вычитать; изымать; отчуждать; лишать
subtraction = изъятие; отчуждение; лишение; вычитание; отбавка
succeed = достигнуть цели; добиться; иметь успех; следовать
succinct = краткий; лаконичный
succinctly = сжато; коротко; вкратце
sudden = внезапный; неожиданный; непредвиденный; стремительный; поспешный; вдруг
suddenly = внезапно; вдруг; неожиданно; непредвиденно; откуда не возьмись
suffice = достаточно; удовлетворять; хватить
sufficient = достаточный; довольно; достаточно; соответствующий
suggest = предлагать; советовать; подсказывать; намекать
suitable = подходящий; соответствующий; годный; надлежащий
suite = набор; комплект
sullying = пачкать; марать; пятнать; запачкать; запятнать; очернить
summary = краткое изложение; резюме; сводная таблица
superficial = поверхностный; неглубокий; внешний; наносный; мелкий
superfluous = обильный; более чем достаточный; излишний; чрезмерный; избыточный; ненужный; лишний; изобильный; слово-паразит
superiority = старшинство; превосходство; преимущество; первенство; господство
supplant = вытеснять; выживать; искоренять
supplied = снабжать; поставлять; доставлять; давать; питать; восполнять
supply = запас; припасы; продовольствие; снабжение; поставка
suppress = подавлять; сдерживать; запрещать
supreme = высшая степень; максимальный; бог; всевышний
surefire = безошибочный; верный; надёжный; проверенный; безотказный
surmise = предполагать; подозревать; высказывать догадку; заподозрить; догадываться; гадать
survey = обозрение; осмотр; обзор; инспектирование; обследование
susceptible = подверженный; впечатлительный; чувствительный; обидчивый; допускающий; поддающийся; восприимчивый; влюбчивый; доступный
suspend = вешать; подвешивать; приостанавливать; откладывать; временно отстранять; исключать
sustain = подпирать; подкреплять; подтверждать; поддержать
swag = пожитки; взятка; отвислый; провисать
swap = обменивать; меняться; меняться местами; заключить сделку
sweatshop = предприятие каторжного труда; потогонная фабрика; галеры
sweep = выметание; подметание; трубочист; течение; непрестанное движение; размах; взмах; кругозор; охват; изгиб
swiftly = быстро; поспешно; оперативно
synergy = совместная деятельность; тесное взаимодействие; координация
tacit = подразумеваемый; безмолвный; неписаный закон; не выраженный словами
tackle = хватать; останавливать; энергично браться; всерьёз приниматься за дело; запрягать; инструмент; оборудование; снаряжение
tackling = удержать; энергично взяться; пытаться убедить; запрягать; седлать; закреплять снастями
tad = мальчонка; пострелёнок; капелька; чуточка; малость
tag = ярлык; этикетка; бирка; навешивать ярлычок; соединять; связывать; скреплять; прилагать; прикреплять
tail = хвост; коса; косичка; оконечность; конец
tailor = шить; портняжничать; быть портным; предназначать для определенной цели; изготовлять для специального применения
tailored = строгих линий; простой; гладкий; строгий; сделанный портным; выкроенный и сшитый
taint = разлагать; заражать; портить; пятнать; осквернить
takeaway = основная мысль; раздаточный материал; вынесенный урок; тормозок
tangent = касательная линия; функция тангенс; касательный; соединяющийся; соприкасающийся; смежный
tangible = вещественный; материальный; реальный; ощутимый; осязаемый
tap = пробка; затычка; кран; марка; стук; набойка; ответвление
tardiness = опоздание; медлительность; мешкотность; запоздалость
tardy = запоздавший; опоздавший; запоздалый; медлительный; неспешный; несвоевременный
taught = обучаемый; обучаться; обученный
taxonomy = классификация; систематизация; соподчинение
teardown = освобождение; разъединение; демонтаж
tedious = скучный; утомительный; нудный; банальный
tedium = скука; утомительность; монотонность; тоска; нудность
telescoping = выдвигать; раздвигать; складывать
telltale = выдающий; свидетельствующий; предательский; сигнальный; красноречивый; заметный
tempt = уговаривать; склонять; подбивать; соблазнять; заманивать; прельщать
tend = склоняться; иметь тенденцию; ухаживать
tenet = убеждение; установка; положение; догма
tension = напряжение; напряжённость; натянутость; неловкость; напряжённое состояние; растяжение
tenuous = тонкий; разрежённый; очень тонкий; тончайший; поверхностный
terms = срок; продолжительность; семестр; сессия; термин
ternary = троичный
terse = краткий; сжатый; немногословный; выразительный
testified = показывать; свидетельствовать; подтверждать
testimony = доказательство; утверждение; заявление; показание свидетеля
theorize = теоретически предсказывать; теоретизировать; создать теорию
thereby = таким образом; в связи с этим; посредством этого; из-за этого; тем самым; вследствие этого
therein = в этом отношении; в то место; туда; тут; в том месте; в; в этом; в таковом; в вышеуказанном
thinly = деликатно; экономно; понемногу; плохо; кое-как; тонко
thoroughly = вполне; совершенно; тщательно; основательно; досконально; всесторонне
though = хоть; хотя; несмотря на; всё же; даже; если бы; хотя бы
thought = мышление; мысль; соображение; подразумевал; считал; предполагал; думал
threshold = порог; граница
through = через; транзитный; сквозной; свободный; беспрепятственный
throughput = выработка; производительность; пропускная способность; скорость обработки
thumb = большой палец; захватать; загрязнить; пролистать; бегунок; валик
thwart = перечить; мешать исполнению; срывать; мешать
tick = тиканье; тик-так; отметка
tidy = опрятный; аккуратный; чистый; значительный; в порядке; здоровый; порядочный; приличный
tie = соединение; галстук
tier = уровень; ряд; ярус; крепление; чин
tight = тугой; плотный; непроницаемый; компактный; тесный
tighten = сжимать; натягивать; затягивать; подтягивать; уплотнять; скреплять; стеснять
timid = застенчивый; неуверенный; робкий; пугливый
tinker = паять; возиться
tip = конец; верхушка; наконечник
tips = полезная информация; полезные советы
toe = палец ноги; носок; передняя часть копыта
token = знак; символ; признак; примета
topic = тема; проблематика; предмет обсуждения; тема дискуссии; сюжет
topping = покрывать; перевалить; перепрыгнуть; увенчивать; быть во главе; превосходить; верхушка; верх
toss = бросок; качка; колебания; тряска
toward = будущий; грядущий; предстоящий; по отношению; относительно
trace = следить; выслеживать; преследовать
tradeoff = компромисс; уступка; выбор оптимального соотношения
trait = характерная черта; особенность; свойство; штрих; натяжка; черта; проявление
transient = преходящий; кратковременный; мимолётный; скоротечный; временный
transition = переход; переключение; трансформация
transitive = переходной; промежуточный
transitively = транзитивно; переходяще
transmit = сообщать; передавать по наследству; посылать; отправлять; пропускать; транслировать
transparent = прозрачный; просвечивающий; явный; очевидный
traverse = проходить; возражать; класть попёрек; отрицать; переправляться; противоречить; изъездить
tray = поднос; поддон; мелкое корыто; пепельница
tread = ступать; ступень; колея
treat = обращаться; трактовать; относиться; подвергать; обработать
treatise = трактат; научный труд; учебник; исследование; рассуждение
treatment = обращение; обхождение; трактовка; лечение; уход; обработка; режим
tremendous = огромный; гигантский; страшный; ужасный; колоссальный
trump = получить преимущество; быть более важным чем; превосходить; превзойти; побить; бить козырем; покрывать
truncate = усекать; обрезать; отсекать верхушку; сокращать; изувечить; искалечить
truncation = срезание; усечение; срез; сокращение
tuck = подсунуть; прятать; заправлять; подворачивать; делать складки; подогнуть
tuple = кортеж; кратный
turn-off = разъезд; нечто отвращающее; нечто отбивающее интерес
turpentine = живица; скипидар
tweak = корректировка; настройка; отладка
twiddle = вертеть; крутить; бездельничать; бить баклуши; верчение; завиток; украшение; трель; дрожание голоса
twist = скручивать; обвивать
typically = типично; как правило; часто; неудивительно; обыкновенно
ubiquitous = вездесущий; повсеместный
ultimately = в конечном счете, в конце концов; в итоге
umpteen = многочисленный
unaffected = не подверженный; простой; непринуждённый; искренний; непритворный; безучастный; равнодушный
unambiguous = однозначный; недвусмысленный; точно выраженный; ясный
unappealing = непривлекательный; несоблазнительный; неприглядный
unassuming = непритязательный; скромный
unaware = незнающий; неподозревающий; без предупреждения; не отдавая себе отчёта; не сознавая; неосведомлённый
unbearable = невыносимый; нетерпимый; нестерпимый; невмоготу
uncertainty = неуверенность; нерешительность; изменчивость; неизвестность; неопределённость
uncommon = редкий; необычный; незаурядный; необыкновенный; замечательный; необычайный
unconditionally = безусловно; безоговорочно; без замечаний
unconventional = чуждый условностям; нетрадиционный; нешаблонный; необычный; неординарный; нетривиальный
uncover = раскрывать; обнаруживать; открывать; обнажать
undeniably = неоспоримый; несомненный; явный; превосходный; великолепный; несомнительный
undergo = испытывать; переносить; подвергаться
underneath = нижний; находящийся ниже или внизу; внизу; ниже; под; вниз; внутри
underscore = подчёркивать; делать ударение; делать акцент; нижнее подчёркивание
undertake = предпринимать; брать на себя; ручаться; гарантировать; предпринять; взять обязательство
undertow = подводное течение; отлив прибоя; глубинное течение
undoubtedly = несомненно; без сомнения; спору нет
undue = чрезмерный; неподходящий; несвоевременный
unenforceable = недействительный; не имеющий законной силы; невыполнимый
unflappable = невозмутимый; хладнокровный; не теряющий присутствия духа
unforeseen = непредвиденный; непредусмотренный; случайный; непредугаданный
unforgeable = неподдельный
unfulfilled = невыполненный; неосуществлённый; неисполненный; опустошённый
unhindered = беспрепятственный; невозбранимый; невозбранный
unidirectional = однонаправленный; в одном направлении; неизменного направления
uniform = однообразный; единообразный; однородный
uniformly = равномерно; поголовно; по единому принципу; однообразно; ровно
unify = унифицировать; объединять; сплотить; обобщать
unintended = непредусмотренный; неумышленный; непреднамеренный; нежелательный
unintentional = неумышленный; ненамеренный; нечаянный; непредусмотренный; бессознательный
uninterpreted = неистолкованный; необъяснённый; неинтерпретируемый
uninterruptibly = безостановочный; непрерывный; непрерываемый
unkempt = неопрятный; неряшливый; запущенный; нечёсаный; небрежный
unknowable = непознаваемый; непостижимый; неисповедимый
unleashed = разнузданный; реализованный; развязанный; высвобожденный; подробное руководство
unless = не считая; оговорка; помимо; разве что
unobtrusive = скромный; ненавязчивый; незаметный; необязывающий
unpredictability = непредсказуемость; трудность прогнозирования
unpredictable = непредсказуемый; не поддающийся прогнозированию; не могущий быть предсказанным; непредвиденный; капризный
unreliable = ненадёжный; недостоверный; неблагонадёжный; необязательный
unsettle = нарушать распорядок; выбивать из колеи; расстраивать; беспокоить
unsettling = вызывающий беспокойство; нарушать распорядок; выбивать из колеи; расстраивать; беспокоящий; тревожащий
unsightly = некрасивый; уродливый; неприглядный; невзрачный; безобразный
unwieldy = громоздкий; тяжеловесный; неповоротливый; неуклюжий
unwind = разматывать; раскручивать; развиваться; распутывать
upset = опрокидывать; опрокидываться; расстраивать; выводить из; нарушать пищеварение; осаживать; беспокоить
urge = побуждение; толчок; натиск; стремление; порыв
usefulness = полноценность; достоинство; целесообразность; эффективность; благоприятность
utensil = посуда; утварь; принадлежность
utilization = использование; утилизация; привлечение; заполнение; способ
utmost = предел возможного; наиболее; крайняя степень; крайний; предельный
vagary = непредсказуемость; чудачество; прихоть; случайность
vague = неопределённый; туманный; нечёткий; неясный; смутный; рассеянный; неуловимый; отсутствующий
vaguely = неясно; смутно; туманно; неопределённо; расплывчато
valid = действующий; веский; обоснованный; действительный; имеющий силу; основательный
validate = утверждать; ратифицировать; объявлять действительным; обосновать
validity = обоснованность; правильность
valuable = ценный; дорогой; дорогостоящий; полезный; драгоценный
value = значение; смысл; стоимость; цена
vanity = суета; суетность; тщета; тщеславие; дамская сумочка
varargs = аргументы переменной длинны; с неопределённым числом аргументов
vast = обширный; подавляющий; огромный; громадный; безбрежный; многочисленный
vein = ход; канал; источник; склонность; жилка; настроение; расположение; творческий подъём; прожилка; вена; кровеносный сосуд; жила
vendor = поставщик; продавец; торговец; разработчик; разносчик
venerable = почтенный; древний; преподобный; маститый; досточтимый; авторитетный
venue = место встречи; место сбора; место проведения
verb = глагол; имя команды; операция; сказуемое
verbatim = стенограмма; стенографический отчёт; дословная передача; слово в слово
verbose = многословный; многоречивый; пространный; словообильный
verbosity = многословие; пространность; пустозвонство; словоохотливость
verify = проверять; подтверждать; исполнять; скреплять; проверить; засвидетельствовать; удостоверять
versatile = разносторонний; изменчивый; шаткий; неустойчивый; гибкий; подвижной
versatility = разносторонность; непостоянство; неустойчивость; переменчивость; изменчивость; многоплановость
verses = поэзия; строфа; стихи
vertice = вершина точки; вершина
vestige = след; признак; рудимент; остаток
viable = жизнеспособный; конкурентный; целесообразный; веский
vibrant = трепещущий; дрожащий; вибрирующий; резонирующий; потрясающий; динамичный
vice = сжимать; стискивать
violate = нарушать; преступать; попирать; осквернять; оскорблять; вторгаться
violation = нарушение; противоречие; надругательство
virtually = фактически; практически; в действительности; реально; по существу
virtue = добродетель; нравственность; целомудрие; преимущество
vital = жизненный; жизненно важный; насущный; крайне необходимый; энергичный
vocabulary = лексика; словарный состав; словарь; список слов; запас слов; основные термины; лексический запас; лексический состав
volatile = непостоянный; изменчивый; ветреный; капризный; живой; весёлый; беспечный
volley = залп; град; поток; удар с лёта; очередь; порция
voluntarily = добровольно; умышленно; сознательно; преднамеренно; нарочито; нарочно
vouch = ручаться; подтверждать; подкреплять; давать гарантию
vow = клятва верности; зарок; обет; завет
vulnerability = уязвимость; ранимость; слабое место; слабое звено
vulnerable = уязвимый; ранимый; слабозащищённый
wager = держать пари; биться об заклад
wallet = бумажник; футляр; сумка; котомка; кошелёк
warp = коробиться; деформироваться; искривляться
warrant = ручаться; гарантировать; подтверждать; гарантия; патент; ордер
wart = бородавка; нарост; с недостатками; налёт
waste = растрачивание; расточительство; потери; убыль; ущерб; убыток; отходы; обрезки; утиль
weakling = слабое существо; заморыш; горе луковое; бесхарактерный человек
wealth = богатство; обилие; изобилие; положение; состояние
wedge = клин
weigh = взвешиваться; весить; иметь вес, значение; влиять
well-intentioned = благонамеренный; благомыслящий; из лучших побуждений; доброжелательный; с добрым намерением
whatsoever = вообще; совсем; какой бы ни; что бы ни; какой бы то ни было; какой угодно
whence = откуда; как; почему; туда откуда; каким образом; место возникновения; причина возникновения; по какой причине; таким образом; источник; происхождение
whereby = посредством чего; в соответствии с чем
wherein = там; где; в чём; когда; в котором; при котором
whiner = нытик; пискля
whoop = возглас; вопль; гиканье; уханье
wide = широкий; от края до края; обширный; пространный
widespread = широкомасштабный; распространённый; раскинувшийся; масштабный; обширный; повсеместный
wildcard = символ; признак; шаблонный знак; специальный символ
wildcarding = подстановочные знаки
will = заставлять; внушать; завещать; проявлять волю; хотеть; приказать; велеть
willing = готовый; склонный; расположенный; согласный; не возражающий; старательный; усердный
wipe = вытирание; издёвка; утирать; уничтожить
wishful = определяемый желанием; желаемый; желающий; жаждущий; тоскливый
within = внутри; изнутри; в пределах
withstand = вытерпеть; вытерпливать; противостать; устоять; выстоять; не поддаваться
woefully = удручающе; прискорбно; горестно; печально; к сожалению
workaround = обходное решение; выход из ситуации; обойти
worth = ценность; цена; стоящий; достойный
worthless = ничего не стоящий; бесполезный; никчёмный; никудышный
worthwhile = стоящий; дающий результат; полезный; выгодный
wove = ткать; сплетать; вплетать; сплетаться; сливаться
wreak = изливать; причинять ущерб; мстить
yield = уступать; производить; приносить; давать; сдавать
yowl = выть; орать
zeroed = определять; находить нуль; пристреливаться; обнулять
zeroth = нулевой, нулевого порядка

